Age,Attrition,BusinessTravel,DailyRate,Department,DistanceFromHome,Education,EducationField,EmployeeCount,EmployeeNumber,EnvironmentSatisfaction,Gender,HourlyRate,JobInvolvement,JobLevel,JobRole,JobSatisfaction,MaritalStatus,MonthlyIncome,MonthlyRate,NumCompaniesWorked,Over18,OverTime,PercentSalaryHike,PerformanceRating,RelationshipSatisfaction,StandardHours,StockOptionLevel,TotalWorkingYears,TrainingTimesLastYear,WorkLifeBalance,YearsAtCompany,YearsInCurrentRole,YearsSinceLastPromotion,YearsWithCurrManager
43,No,Travel_Rarely,1205,Sales,3,3,Life Sciences,1,1,3,Male,88,4,3,Sales Executive,3,Married,6850,20145,5,Y,No,12,4,3,80,1,15,2,3,8,6,2,4
38,Yes,Travel_Frequently,445,Research & Development,12,2,Medical,1,2,2,Female,75,3,2,Research Scientist,2,Single,4680,18925,3,Y,Yes,18,3,4,80,0,12,3,2,7,5,1,3
29,No,Non-Travel,892,Research & Development,8,4,Life Sciences,1,3,4,Male,65,3,1,Laboratory Technician,4,Divorced,3250,14789,2,Y,No,15,3,3,80,2,8,4,3,4,3,0,2
52,No,Travel_Rarely,756,Sales,5,3,Marketing,1,4,3,Female,92,2,4,Manager,3,Married,16500,22368,1,Y,Yes,14,4,4,80,0,25,1,4,20,15,8,12
31,Yes,Travel_Frequently,623,Research & Development,15,1,Technical Degree,1,5,1,Male,58,2,1,Laboratory Technician,1,Single,2840,16895,4,Y,Yes,13,3,2,80,0,6,2,2,3,2,1,1
26,No,Travel_Rarely,1134,Human Resources,7,2,Human Resources,1,6,3,Female,71,3,2,Human Resources,3,Married,4125,11256,1,Y,No,16,3,3,80,1,5,3,3,3,2,0,2
47,No,Non-Travel,389,Research & Development,18,4,Medical,1,7,2,Male,83,4,3,Healthcare Representative,2,Divorced,11850,19547,6,Y,No,11,4,2,80,3,22,4,4,18,12,5,8
33,Yes,Travel_Rarely,978,Sales,9,3,Life Sciences,1,8,4,Female,46,2,2,Sales Representative,4,Single,3680,7894,7,Y,Yes,19,3,3,80,0,9,3,3,6,4,2,3
25,No,Travel_Frequently,1287,Research & Development,22,2,Life Sciences,1,9,3,Male,39,3,1,Research Scientist,2,Married,2950,21456,0,Y,No,20,4,4,80,1,3,5,3,2,1,0,1
55,No,Travel_Rarely,467,Sales,6,5,Marketing,1,10,4,Female,95,3,5,Manager,4,Single,18750,13268,3,Y,Yes,13,4,3,80,1,32,2,4,28,18,12,15
39,No,Travel_Frequently,825,Research & Development,11,3,Medical,1,11,2,Male,72,2,2,Manufacturing Director,3,Married,7250,16874,2,Y,No,17,3,3,80,2,14,3,3,11,8,3,6
28,Yes,Travel_Rarely,541,Sales,16,1,Marketing,1,12,3,Female,54,3,2,Sales Executive,3,Divorced,5420,9876,5,Y,Yes,14,3,2,80,0,6,4,2,4,3,1,2
44,No,Non-Travel,1156,Research & Development,4,4,Life Sciences,1,13,1,Male,87,4,3,Research Director,1,Married,14680,25147,1,Y,No,12,4,1,80,2,18,2,4,15,11,7,9
36,No,Travel_Rarely,698,Human Resources,13,3,Human Resources,1,14,4,Female,63,3,3,Manager,4,Single,12450,18569,2,Y,No,15,3,4,80,0,12,3,3,8,6,4,5
24,Yes,Travel_Frequently,1349,Research & Development,25,2,Technical Degree,1,15,2,Male,41,2,1,Laboratory Technician,2,Single,2650,13478,1,Y,Yes,22,4,3,80,0,2,6,2,1,0,0,0
48,No,Travel_Rarely,784,Sales,8,4,Life Sciences,1,16,3,Female,89,3,3,Sales Executive,3,Married,9850,20145,4,Y,No,16,3,3,80,1,21,3,3,17,13,6,10
32,No,Travel_Frequently,462,Research & Development,19,3,Medical,1,17,4,Male,76,2,2,Research Scientist,4,Divorced,4750,17896,3,Y,Yes,18,3,4,80,1,8,4,2,6,5,2,4
27,Yes,Non-Travel,1093,Sales,12,2,Marketing,1,18,1,Female,52,3,1,Sales Representative,1,Single,3250,14587,6,Y,No,17,3,2,80,0,4,2,3,2,1,0,1
41,No,Travel_Rarely,635,Research & Development,6,3,Life Sciences,1,19,2,Male,94,4,4,Manager,2,Married,15680,19874,2,Y,Yes,13,4,2,80,3,16,1,4,14,10,5,8
35,No,Travel_Frequently,1278,Human Resources,21,4,Human Resources,1,20,3,Female,68,3,2,Human Resources,3,Single,5680,22456,1,Y,No,19,3,3,80,2,11,3,3,9,7,3,5
30,Yes,Travel_Rarely,749,Research & Development,14,1,Medical,1,21,4,Male,57,2,1,Laboratory Technician,4,Married,3150,16789,4,Y,Yes,16,3,4,80,0,7,2,2,5,3,1,2
53,No,Non-Travel,1186,Sales,3,5,Marketing,1,22,1,Female,91,4,5,Manager,1,Divorced,19250,24568,5,Y,No,11,4,1,80,1,28,4,4,24,16,10,13
37,No,Travel_Rarely,568,Research & Development,17,3,Life Sciences,1,23,2,Male,73,3,2,Research Scientist,2,Single,5280,15687,3,Y,Yes,20,4,2,80,1,13,3,3,10,7,4,6
26,Yes,Travel_Frequently,1345,Sales,29,2,Technical Degree,1,24,3,Female,45,2,1,Sales Representative,3,Married,2980,13456,2,Y,No,21,4,3,80,0,3,4,2,2,1,0,1
49,No,Travel_Rarely,692,Research & Development,7,4,Medical,1,25,4,Male,88,3,4,Healthcare Representative,4,Divorced,12850,21387,6,Y,Yes,14,3,4,80,2,23,2,3,19,14,8,11
34,No,Travel_Frequently,1057,Human Resources,10,3,Human Resources,1,26,2,Female,66,4,3,Manager,2,Single,11250,18947,1,Y,No,17,4,2,80,1,10,5,4,8,6,3,5
23,Yes,Non-Travel,838,Research & Development,23,1,Life Sciences,1,27,3,Male,51,2,1,Laboratory Technician,3,Single,2450,14758,0,Y,Yes,18,3,3,80,0,1,3,2,1,0,0,0
56,No,Travel_Rarely,471,Sales,5,5,Marketing,1,28,1,Female,93,3,5,Manager,1,Married,20150,23689,7,Y,No,12,4,1,80,3,33,3,4,29,20,14,16
38,No,Travel_Frequently,1269,Research & Development,18,4,Medical,1,29,4,Male,79,2,2,Manufacturing Director,4,Divorced,8450,19856,3,Y,Yes,15,3,4,80,1,14,4,2,11,8,5,7
29,Yes,Travel_Rarely,546,Sales,26,2,Life Sciences,1,30,2,Female,58,3,2,Sales Executive,2,Single,4750,16487,4,Y,No,19,3,2,80,0,6,3,3,4,3,1,2
42,No,Non-Travel,1194,Research & Development,9,3,Technical Degree,1,31,3,Male,86,4,3,Research Director,3,Married,16850,25478,2,Y,No,13,4,3,80,2,17,2,4,14,11,6,9
31,No,Travel_Rarely,673,Human Resources,15,4,Human Resources,1,32,4,Female,64,3,2,Human Resources,4,Single,6250,17896,1,Y,Yes,16,3,4,80,1,8,4,3,6,4,2,3
25,Yes,Travel_Frequently,1367,Research & Development,27,1,Life Sciences,1,33,1,Male,42,2,1,Research Scientist,1,Married,2850,14569,3,Y,Yes,22,4,1,80,0,2,5,2,1,0,0,1
47,No,Travel_Rarely,715,Sales,4,4,Marketing,1,34,2,Female,90,3,4,Sales Executive,2,Divorced,11450,22147,5,Y,No,14,3,2,80,3,20,3,3,16,12,7,10
33,No,Travel_Frequently,1089,Research & Development,20,3,Medical,1,35,3,Male,75,4,2,Laboratory Technician,3,Single,4150,18736,2,Y,Yes,17,3,3,80,1,9,3,3,7,5,2,4
28,Yes,Non-Travel,562,Sales,13,2,Marketing,1,36,4,Female,53,2,1,Sales Representative,4,Single,3450,15689,6,Y,No,18,3,4,80,0,5,2,2,3,2,1,1
54,No,Travel_Rarely,1275,Research & Development,8,5,Life Sciences,1,37,1,Male,92,3,5,Manager,1,Married,19750,24568,4,Y,Yes,11,4,1,80,2,31,4,4,27,18,13,15
36,No,Travel_Frequently,648,Human Resources,22,3,Human Resources,1,38,2,Female,71,3,3,Human Resources,2,Divorced,7850,19456,1,Y,No,15,3,2,80,1,12,3,3,9,7,4,6
24,Yes,Travel_Rarely,1383,Research & Development,16,2,Technical Degree,1,39,3,Male,46,2,1,Laboratory Technician,3,Married,2750,13687,2,Y,Yes,20,4,3,80,0,3,4,2,2,1,0,1
43,No,Non-Travel,591,Sales,6,4,Life Sciences,1,40,4,Female,87,4,3,Sales Executive,4,Single,10250,21478,3,Y,No,12,4,4,80,1,18,2,4,15,11,8,9
32,No,Travel_Rarely,1167,Research & Development,11,3,Medical,1,41,1,Male,69,3,2,Research Scientist,1,Married,5150,17896,4,Y,Yes,19,3,1,80,2,8,5,3,6,4,2,3
27,Yes,Travel_Frequently,789,Sales,24,1,Marketing,1,42,2,Female,55,2,2,Sales Representative,2,Divorced,3850,14789,7,Y,No,16,3,2,80,0,4,3,2,3,2,1,2
48,No,Travel_Rarely,426,Research & Development,7,4,Life Sciences,1,43,3,Male,91,4,4,Healthcare Representative,3,Single,13450,22568,5,Y,Yes,13,4,3,80,3,22,3,4,18,14,9,12
35,No,Travel_Frequently,1298,Human Resources,19,3,Human Resources,1,44,4,Female,67,3,2,Human Resources,4,Married,8250,19857,2,Y,No,17,3,4,80,1,11,4,3,8,6,3,5
26,Yes,Non-Travel,574,Research & Development,28,2,Technical Degree,1,45,1,Male,48,2,1,Laboratory Technician,1,Single,2650,15478,1,Y,Yes,21,4,1,80,0,3,2,2,2,1,0,1
51,No,Travel_Rarely,1185,Sales,5,5,Marketing,1,46,2,Female,94,3,5,Manager,2,Divorced,18450,23689,6,Y,No,14,4,2,80,2,26,3,4,22,16,11,14
39,No,Travel_Frequently,659,Research & Development,12,4,Medical,1,47,3,Male,78,2,3,Manufacturing Director,3,Married,9150,18746,3,Y,Yes,15,3,3,80,1,15,4,2,12,9,6,8
30,Yes,Travel_Rarely,1374,Sales,21,2,Life Sciences,1,48,4,Female,56,3,2,Sales Executive,4,Single,5250,16587,5,Y,No,18,3,4,80,0,7,3,3,5,4,2,3
45,No,Non-Travel,493,Research & Development,9,3,Medical,1,49,1,Male,85,4,4,Research Director,1,Married,17250,24578,1,Y,No,12,4,1,80,3,19,2,4,16,12,8,10
33,No,Travel_Rarely,1086,Human Resources,14,4,Human Resources,1,50,2,Female,63,3,3,Manager,2,Single,10850,18967,2,Y,Yes,16,3,2,80,1,9,5,3,7,5,3,4
28,Yes,Travel_Frequently,567,Research & Development,25,1,Life Sciences,1,51,3,Male,49,2,1,Research Scientist,3,Married,3150,14789,4,Y,Yes,19,3,3,80,0,5,4,2,3,2,1,2
52,No,Travel_Rarely,1273,Sales,6,5,Marketing,1,52,4,Female,88,3,4,Sales Executive,4,Divorced,12650,21478,7,Y,No,13,4,4,80,2,27,3,3,23,17,12,15
37,No,Travel_Frequently,641,Research & Development,17,3,Technical Degree,1,53,1,Male,72,4,2,Laboratory Technician,1,Single,4650,17896,3,Y,Yes,17,3,1,80,1,13,4,3,10,7,4,6
25,Yes,Non-Travel,1391,Sales,29,2,Marketing,1,54,2,Female,44,2,1,Sales Representative,2,Single,3250,13568,2,Y,No,20,4,2,80,0,2,3,2,1,0,0,0
46,No,Travel_Rarely,518,Research & Development,8,4,Medical,1,55,3,Male,90,3,3,Healthcare Representative,3,Married,11850,19657,6,Y,Yes,14,3,3,80,3,21,4,3,17,13,8,11
34,No,Travel_Frequently,1174,Human Resources,20,3,Human Resources,1,56,4,Female,66,4,3,Human Resources,4,Divorced,7450,18746,1,Y,No,15,4,4,80,1,10,3,4,8,6,3,5
29,Yes,Travel_Rarely,695,Research & Development,13,2,Life Sciences,1,57,1,Male,54,2,2,Research Scientist,1,Single,3850,16489,3,Y,Yes,18,3,1,80,0,6,5,2,4,3,1,2
53,No,Non-Travel,1287,Sales,7,5,Marketing,1,58,2,Female,92,4,5,Manager,2,Married,19650,24678,5,Y,No,11,4,2,80,3,30,2,4,26,19,14,17
38,No,Travel_Rarely,573,Research & Development,16,4,Medical,1,59,3,Male,77,3,3,Manufacturing Director,3,Single,8750,18957,4,Y,Yes,16,3,3,80,1,14,3,3,11,8,5,7
27,Yes,Travel_Frequently,1368,Sales,26,1,Life Sciences,1,60,4,Female,45,2,1,Sales Representative,4,Married,2950,14678,6,Y,No,21,4,4,80,0,4,4,2,3,2,1,1
49,No,Travel_Rarely,692,Research & Development,10,5,Technical Degree,1,61,1,Male,89,4,4,Research Director,1,Divorced,16450,23568,2,Y,Yes,13,4,1,80,2,24,3,4,20,15,10,13
35,No,Travel_Frequently,1056,Human Resources,23,3,Human Resources,1,62,2,Female,68,3,2,Human Resources,2,Single,6850,17896,3,Y,No,17,3,2,80,1,11,4,3,9,7,4,6
26,Yes,Non-Travel,584,Research & Development,18,2,Life Sciences,1,63,3,Male,52,2,1,Laboratory Technician,3,Single,2750,15687,1,Y,Yes,19,3,3,80,0,3,3,2,2,1,0,1
44,No,Travel_Rarely,1265,Sales,5,4,Marketing,1,64,4,Female,91,3,4,Sales Executive,4,Married,11250,20147,4,Y,No,14,3,4,80,3,19,2,3,16,12,7,10
32,No,Travel_Frequently,678,Research & Development,15,3,Medical,1,65,1,Male,74,4,2,Research Scientist,1,Divorced,4950,18746,2,Y,Yes,15,4,1,80,1,8,5,3,6,4,2,3
28,Yes,Travel_Rarely,1376,Sales,27,2,Life Sciences,1,66,2,Female,48,2,2,Sales Representative,2,Single,3450,14789,5,Y,No,18,3,2,80,0,5,3,2,3,2,1,2
47,No,Non-Travel,505,Research & Development,9,4,Technical Degree,1,67,3,Male,87,3,3,Healthcare Representative,3,Married,12650,21478,6,Y,Yes,12,4,3,80,2,22,3,3,18,14,9,12
36,No,Travel_Rarely,1183,Human Resources,22,3,Human Resources,1,68,4,Female,65,4,3,Manager,4,Single,9450,19867,1,Y,No,16,4,4,80,1,12,4,4,9,7,4,6
25,Yes,Travel_Frequently,597,Research & Development,14,1,Life Sciences,1,69,1,Male,51,2,1,Research Scientist,1,Married,2850,15689,3,Y,Yes,20,4,1,80,0,2,4,2,1,0,0,1
52,No,Travel_Rarely,1278,Sales,6,5,Marketing,1,70,2,Female,93,3,5,Manager,2,Divorced,18850,23789,7,Y,No,13,4,2,80,3,28,2,4,24,18,13,16
39,No,Travel_Frequently,651,Research & Development,19,4,Medical,1,71,3,Male,76,2,2,Manufacturing Director,3,Single,8150,17956,3,Y,Yes,17,3,3,80,1,15,3,2,12,9,6,8
31,Yes,Non-Travel,1387,Sales,25,2,Marketing,1,72,4,Female,47,3,1,Sales Representative,4,Single,3650,14578,4,Y,No,19,3,4,80,0,7,5,3,5,4,2,3
46,No,Travel_Rarely,474,Research & Development,8,4,Life Sciences,1,73,1,Male,88,4,4,Research Director,1,Married,16250,22468,5,Y,Yes,14,4,1,80,2,20,3,4,17,13,8,11
33,No,Travel_Frequently,1095,Human Resources,21,3,Human Resources,1,74,2,Female,67,3,2,Human Resources,2,Divorced,7650,18756,2,Y,No,15,3,2,80,1,9,4,3,7,5,3,4
29,Yes,Travel_Rarely,586,Research & Development,16,2,Technical Degree,1,75,3,Male,53,2,1,Laboratory Technician,3,Single,3250,15789,1,Y,Yes,21,4,3,80,0,6,3,2,4,3,1,2
55,No,Non-Travel,1286,Sales,7,5,Marketing,1,76,4,Female,92,4,5,Manager,4,Married,19450,24678,6,Y,No,11,4,4,80,3,32,2,4,28,20,15,18
37,No,Travel_Rarely,663,Research & Development,12,3,Medical,1,77,1,Male,79,3,3,Healthcare Representative,1,Single,9250,19567,4,Y,Yes,16,3,1,80,1,13,4,3,10,7,4,6
26,Yes,Travel_Frequently,1379,Sales,28,1,Life Sciences,1,78,2,Female,45,2,2,Sales Executive,2,Married,3850,14689,7,Y,No,18,3,2,80,0,3,5,2,2,1,0,1
48,No,Travel_Rarely,598,Research & Development,9,4,Medical,1,79,3,Male,86,3,3,Manufacturing Director,3,Divorced,11450,20478,3,Y,Yes,13,4,3,80,2,23,3,3,19,15,10,13
34,No,Travel_Frequently,1176,Human Resources,24,3,Human Resources,1,80,4,Female,68,4,2,Human Resources,4,Single,8250,18967,1,Y,No,17,4,4,80,1,10,3,4,8,6,3,5
30,Yes,Non-Travel,687,Research & Development,17,2,Life Sciences,1,81,1,Male,56,2,1,Research Scientist,1,Single,3450,16578,2,Y,Yes,19,3,1,80,0,7,4,2,5,4,2,3
51,No,Travel_Rarely,1289,Sales,5,5,Marketing,1,82,2,Female,91,3,5,Sales Executive,2,Married,17650,23789,5,Y,No,12,4,2,80,3,26,3,4,22,16,11,14
38,No,Travel_Frequently,575,Research & Development,20,4,Technical Degree,1,83,3,Male,73,4,2,Laboratory Technician,3,Divorced,5250,17856,4,Y,Yes,15,4,3,80,1,14,5,3,11,8,5,7
27,Yes,Travel_Rarely,1382,Sales,29,1,Marketing,1,84,4,Female,49,2,1,Sales Representative,4,Single,2950,14789,6,Y,No,20,4,4,80,0,4,3,2,3,2,1,1
45,No,Non-Travel,512,Research & Development,11,4,Medical,1,85,1,Male,89,3,4,Healthcare Representative,1,Married,13850,21567,2,Y,Yes,14,3,1,80,3,20,2,3,17,13,8,11
35,No,Travel_Rarely,1167,Human Resources,18,3,Human Resources,1,86,2,Female,65,3,3,Manager,2,Single,10450,19678,1,Y,No,16,3,2,80,1,11,4,3,9,7,4,6
26,Yes,Travel_Frequently,692,Research & Development,15,2,Life Sciences,1,87,3,Male,54,2,2,Research Scientist,3,Married,3150,15789,3,Y,Yes,18,3,3,80,0,3,5,2,2,1,0,1
53,No,Travel_Rarely,1278,Sales,6,5,Marketing,1,88,4,Female,94,4,4,Sales Executive,4,Divorced,12850,22478,7,Y,No,13,4,4,80,2,29,3,4,25,19,14,17
40,No,Travel_Frequently,658,Research & Development,23,4,Medical,1,89,1,Male,77,3,3,Manufacturing Director,1,Single,8450,18956,3,Y,Yes,17,3,1,80,1,16,3,3,13,10,6,9
32,Yes,Non-Travel,1394,Sales,26,2,Life Sciences,1,90,2,Female,46,2,1,Sales Representative,2,Single,3750,14689,4,Y,No,19,3,2,80,0,8,4,2,6,4,2,3
49,No,Travel_Rarely,486,Research & Development,8,4,Technical Degree,1,91,3,Male,88,4,4,Research Director,3,Married,15650,23568,5,Y,Yes,12,4,3,80,3,24,2,4,20,15,10,13
36,No,Travel_Frequently,1179,Human Resources,21,3,Human Resources,1,92,4,Female,66,3,2,Human Resources,4,Divorced,7850,18756,2,Y,No,15,3,4,80,1,12,5,3,9,7,4,6
28,Yes,Travel_Rarely,593,Research & Development,14,1,Life Sciences,1,93,1,Male,52,2,1,Laboratory Technician,1,Single,2850,15689,1,Y,Yes,21,4,1,80,0,5,3,2,3,2,1,1
44,No,Non-Travel,1267,Sales,7,4,Marketing,1,94,2,Female,90,3,4,Manager,2,Married,16450,22678,6,Y,No,14,4,2,80,2,19,3,4,16,12,8,11
33,No,Travel_Rarely,679,Research & Development,19,3,Medical,1,95,3,Male,74,4,2,Research Scientist,3,Single,5450,17896,3,Y,Yes,16,4,3,80,1,9,4,3,7,5,3,4
29,Yes,Travel_Frequently,1386,Sales,27,2,Life Sciences,1,96,4,Female,48,2,2,Sales Executive,4,Married,4250,14789,5,Y,No,18,3,4,80,0,6,5,2,4,3,1,2
56,No,Travel_Rarely,504,Research & Development,10,5,Technical Degree,1,97,1,Male,92,3,5,Healthcare Representative,1,Divorced,18250,24678,4,Y,Yes,11,4,1,80,3,33,2,4,29,21,16,19
38,No,Travel_Frequently,1168,Human Resources,22,4,Human Resources,1,98,2,Female,69,4,3,Manager,2,Single,11650,19867,1,Y,No,17,4,2,80,1,14,3,4,11,8,5,7
25,Yes,Non-Travel,685,Research & Development,16,1,Life Sciences,1,99,3,Male,51,2,1,Research Scientist,3,Single,2950,15789,2,Y,Yes,20,4,3,80,0,2,4,2,1,0,0,0
47,No,Travel_Rarely,1279,Sales,5,4,Marketing,1,100,4,Female,91,3,4,Sales Executive,4,Married,13250,21478,6,Y,No,12,4,4,80,2,22,3,4,18,14,9,12
41,No,Travel_Frequently,567,Research & Development,18,3,Medical,1,101,1,Male,75,4,3,Healthcare Representative,1,Divorced,9650,18956,3,Y,Yes,15,3,1,80,1,17,4,3,14,11,7,9
30,Yes,Non-Travel,1395,Sales,25,2,Life Sciences,1,102,2,Female,47,2,2,Sales Representative,2,Single,3850,14789,4,Y,No,19,3,2,80,0,7,5,2,5,4,2,3
54,No,Travel_Rarely,493,Research & Development,9,5,Technical Degree,1,103,3,Male,89,3,5,Research Director,3,Married,17850,24678,5,Y,Yes,13,4,3,80,3,31,2,4,27,19,14,17
37,No,Travel_Frequently,1186,Human Resources,22,4,Human Resources,1,104,4,Female,68,3,2,Human Resources,4,Single,8450,19867,1,Y,No,16,3,4,80,1,13,3,3,10,8,5,7
26,Yes,Travel_Rarely,594,Research & Development,15,1,Life Sciences,1,105,1,Male,53,2,1,Research Scientist,1,Married,2950,15789,2,Y,Yes,20,4,1,80,0,3,4,2,2,1,0,1
45,No,Non-Travel,1278,Sales,6,4,Marketing,1,106,2,Female,92,4,4,Manager,2,Divorced,15250,22678,7,Y,No,14,4,2,80,2,20,3,4,17,13,8,11
34,No,Travel_Rarely,681,Research & Development,20,3,Medical,1,107,3,Male,76,3,2,Manufacturing Director,3,Single,6850,17896,3,Y,Yes,17,3,3,80,1,10,4,3,8,6,4,5
31,Yes,Travel_Frequently,1397,Sales,28,2,Marketing,1,108,4,Female,49,2,1,Sales Executive,4,Single,4150,14789,5,Y,No,18,3,4,80,0,8,5,2,6,4,2,3
48,No,Travel_Rarely,506,Research & Development,11,4,Life Sciences,1,109,1,Male,87,4,4,Healthcare Representative,1,Married,12850,21567,4,Y,Yes,12,4,1,80,3,23,2,4,19,15,10,13
35,No,Travel_Frequently,1175,Human Resources,24,3,Human Resources,1,110,2,Female,67,3,3,Manager,2,Divorced,9850,19678,2,Y,No,15,3,2,80,1,11,4,3,9,7,4,6
27,Yes,Non-Travel,696,Research & Development,17,2,Technical Degree,1,111,3,Male,55,2,1,Laboratory Technician,3,Single,3150,15689,1,Y,Yes,21,4,3,80,0,4,3,2,3,2,1,1
52,No,Travel_Rarely,1287,Sales,7,5,Marketing,1,112,4,Female,93,3,5,Sales Executive,4,Married,16450,23789,6,Y,No,11,4,4,80,3,27,3,4,23,17,12,15
39,No,Travel_Frequently,673,Research & Development,21,4,Medical,1,113,1,Male,78,4,2,Research Scientist,1,Single,7250,18956,3,Y,Yes,16,4,1,80,1,15,5,3,12,9,6,8
28,Yes,Travel_Rarely,1389,Sales,29,1,Life Sciences,1,114,2,Female,46,2,2,Sales Representative,2,Married,3650,14689,7,Y,No,19,3,2,80,0,5,4,2,4,3,1,2
46,No,Non-Travel,518,Research & Development,8,4,Technical Degree,1,115,3,Male,88,3,3,Healthcare Representative,3,Divorced,11450,20478,2,Y,Yes,13,3,3,80,2,21,3,3,17,13,8,11
33,No,Travel_Rarely,1168,Human Resources,16,3,Human Resources,1,116,4,Female,66,4,2,Human Resources,4,Single,7650,18756,1,Y,No,17,4,4,80,1,9,3,4,7,5,3,4
29,Yes,Travel_Frequently,685,Research & Development,12,2,Life Sciences,1,117,1,Male,54,2,1,Research Scientist,1,Single,3250,15789,3,Y,Yes,18,3,1,80,0,6,5,2,4,3,1,2
55,No,Travel_Rarely,1276,Sales,5,5,Marketing,1,118,2,Female,91,4,5,Manager,2,Married,18650,24678,5,Y,No,12,4,2,80,3,32,2,4,28,20,15,18
38,No,Travel_Frequently,597,Research & Development,19,4,Medical,1,119,3,Male,77,3,3,Manufacturing Director,3,Divorced,8650,18967,4,Y,Yes,15,3,3,80,1,14,4,3,11,8,5,7
25,Yes,Non-Travel,1384,Sales,27,1,Marketing,1,120,4,Female,48,2,1,Sales Executive,4,Single,3450,14789,6,Y,No,20,4,4,80,0,2,3,2,1,0,0,0
49,No,Travel_Rarely,512,Research & Development,9,4,Life Sciences,1,121,1,Male,89,4,4,Research Director,1,Married,15850,22568,3,Y,Yes,14,4,1,80,2,24,3,4,20,15,10,13
36,No,Travel_Frequently,1179,Human Resources,23,3,Human Resources,1,122,2,Female,68,3,2,Human Resources,2,Single,8250,19867,1,Y,No,16,3,2,80,1,12,4,3,9,7,4,6
32,Yes,Travel_Rarely,693,Research & Development,15,2,Technical Degree,1,123,3,Male,56,2,2,Laboratory Technician,3,Married,3850,15789,2,Y,Yes,17,3,3,80,0,8,5,2,6,4,2,3
44,No,Non-Travel,1278,Sales,6,4,Marketing,1,124,4,Female,92,3,4,Sales Executive,4,Divorced,12250,21478,7,Y,No,13,4,4,80,3,19,3,4,16,12,7,10
31,No,Travel_Rarely,578,Research & Development,18,3,Medical,1,125,1,Male,74,4,2,Healthcare Representative,1,Single,6450,17896,4,Y,Yes,18,4,1,80,1,7,4,3,5,4,2,3
27,Yes,Travel_Frequently,1392,Sales,26,2,Life Sciences,1,126,2,Female,47,2,1,Sales Representative,2,Single,3250,14689,5,Y,No,19,3,2,80,0,4,3,2,3,2,1,1
53,No,Travel_Rarely,498,Research & Development,10,5,Technical Degree,1,127,3,Male,90,3,5,Research Director,3,Married,17450,23678,4,Y,Yes,11,4,3,80,2,30,2,4,26,18,13,16
40,No,Travel_Frequently,1187,Human Resources,22,4,Human Resources,1,128,4,Female,69,4,3,Manager,4,Divorced,10850,19678,2,Y,No,15,4,4,80,1,16,3,4,13,10,6,9
26,Yes,Non-Travel,674,Research & Development,14,1,Life Sciences,1,129,1,Male,52,2,1,Research Scientist,1,Single,2850,15689,1,Y,Yes,21,4,1,80,0,3,4,2,2,1,0,1
47,No,Travel_Rarely,1285,Sales,7,4,Marketing,1,130,2,Female,93,3,4,Sales Executive,2,Married,14650,22789,6,Y,No,12,4,2,80,3,22,3,4,18,14,9,12
34,No,Travel_Frequently,591,Research & Development,20,3,Medical,1,131,3,Male,75,3,2,Manufacturing Director,3,Single,7250,18756,3,Y,Yes,16,3,3,80,1,10,5,3,8,6,4,5
30,Yes,Travel_Rarely,1398,Sales,28,2,Marketing,1,132,4,Female,49,2,2,Sales Representative,4,Married,4350,14789,5,Y,No,18,3,4,80,0,7,4,2,5,4,2,3
51,No,Non-Travel,516,Research & Development,11,5,Life Sciences,1,133,1,Male,88,4,5,Healthcare Representative,1,Divorced,16250,24567,3,Y,Yes,13,4,1,80,2,26,2,4,22,16,11,14
37,No,Travel_Rarely,1176,Human Resources,24,4,Human Resources,1,134,2,Female,67,3,3,Human Resources,2,Single,9450,19867,1,Y,No,17,3,2,80,1,13,4,3,10,8,5,7
28,Yes,Travel_Frequently,695,Research & Development,17,2,Technical Degree,1,135,3,Male,54,2,1,Laboratory Technician,3,Single,3150,15789,2,Y,Yes,20,4,3,80,0,5,3,2,3,2,1,1
45,No,Travel_Rarely,1289,Sales,5,4,Marketing,1,136,4,Female,91,4,4,Manager,4,Married,15850,23678,7,Y,No,14,4,4,80,2,20,3,4,17,13,8,11
32,No,Travel_Frequently,573,Research & Development,19,3,Medical,1,137,1,Male,76,3,2,Research Scientist,1,Divorced,5650,17896,4,Y,Yes,15,3,1,80,1,8,5,3,6,4,2,3
29,Yes,Non-Travel,1387,Sales,27,1,Life Sciences,1,138,2,Female,48,2,2,Sales Executive,2,Single,3750,14689,6,Y,No,19,3,2,80,0,6,4,2,4,3,1,2
56,No,Travel_Rarely,525,Research & Development,8,5,Technical Degree,1,139,3,Male,92,3,5,Research Director,3,Married,18450,24678,5,Y,Yes,11,4,3,80,3,33,2,4,29,21,16,19
38,No,Travel_Frequently,1168,Human Resources,21,4,Human Resources,1,140,4,Female,68,4,2,Human Resources,4,Single,8650,18967,1,Y,No,16,4,4,80,1,14,3,4,11,8,5,7
25,Yes,Travel_Rarely,685,Research & Development,15,2,Life Sciences,1,141,1,Male,53,2,1,Research Scientist,1,Married,2950,15789,3,Y,Yes,18,3,1,80,0,2,5,2,1,0,0,0
48,No,Non-Travel,1278,Sales,6,4,Marketing,1,142,2,Female,90,3,4,Sales Executive,2,Divorced,13450,21678,4,Y,No,13,4,2,80,2,23,3,4,19,15,10,13
35,No,Travel_Rarely,679,Research & Development,18,3,Medical,1,143,3,Male,74,4,3,Healthcare Representative,3,Single,8250,18756,2,Y,Yes,17,4,3,80,1,11,4,3,9,7,4,6
31,Yes,Travel_Frequently,1396,Sales,25,2,Marketing,1,144,4,Female,46,2,1,Sales Representative,4,Single,3450,14789,5,Y,No,20,4,4,80,0,8,3,2,6,4,2,3
44,No,Travel_Rarely,498,Research & Development,9,4,Life Sciences,1,145,1,Male,87,3,4,Manufacturing Director,1,Married,12850,20567,6,Y,Yes,14,3,1,80,3,19,2,3,16,12,7,10
33,No,Travel_Frequently,1175,Human Resources,22,3,Human Resources,1,146,2,Female,66,3,2,Human Resources,2,Divorced,7850,19678,1,Y,No,15,3,2,80,1,9,4,3,7,5,3,4
28,Yes,Non-Travel,691,Research & Development,16,1,Technical Degree,1,147,3,Male,55,2,1,Laboratory Technician,3,Single,3050,15689,2,Y,Yes,21,4,3,80,0,5,4,2,3,2,1,1
52,No,Travel_Rarely,1287,Sales,7,5,Marketing,1,148,4,Female,93,4,5,Manager,4,Married,17650,24789,7,Y,No,12,4,4,80,3,29,3,4,25,19,14,17
39,No,Travel_Frequently,567,Research & Development,20,4,Medical,1,149,1,Male,78,3,3,Research Scientist,1,Single,7450,18956,3,Y,Yes,16,3,1,80,1,15,5,3,12,9,6,8
26,Yes,Travel_Rarely,1389,Sales,28,2,Life Sciences,1,150,2,Female,47,2,2,Sales Executive,2,Married,3650,14689,6,Y,No,18,3,2,80,0,3,4,2,2,1,0,1
49,No,Non-Travel,516,Research & Development,10,4,Technical Degree,1,151,3,Male,89,4,4,Healthcare Representative,3,Divorced,13250,21478,4,Y,Yes,13,4,3,80,2,24,3,4,20,15,10,13
36,No,Travel_Rarely,1178,Human Resources,23,3,Human Resources,1,152,4,Female,67,3,3,Manager,4,Single,9850,19867,2,Y,No,17,3,4,80,1,12,4,3,9,7,4,6
32,Yes,Travel_Frequently,693,Research & Development,17,2,Life Sciences,1,153,1,Male,56,2,1,Research Scientist,1,Single,3650,15789,1,Y,Yes,19,3,1,80,0,8,5,2,6,4,2,3
45,No,Travel_Rarely,1276,Sales,5,4,Marketing,1,154,2,Female,91,3,4,Sales Executive,2,Married,14250,22678,5,Y,No,14,4,2,80,2,20,3,4,17,13,8,11
33,No,Travel_Frequently,678,Research & Development,19,3,Medical,1,155,3,Male,75,4,2,Manufacturing Director,3,Divorced,6850,17896,3,Y,Yes,15,4,3,80,1,9,4,3,7,5,3,4
29,Yes,Non-Travel,1385,Sales,27,1,Marketing,1,156,4,Female,48,2,1,Sales Representative,4,Single,3450,14789,4,Y,No,20,4,4,80,0,6,3,2,4,3,1,2
54,No,Travel_Rarely,523,Research & Development,11,5,Life Sciences,1,157,1,Male,90,3,5,Research Director,1,Married,16850,23678,6,Y,Yes,11,4,1,80,3,31,2,4,27,19,14,17
41,No,Travel_Frequently,1187,Human Resources,24,4,Human Resources,1,158,2,Female,69,4,3,Human Resources,2,Single,10450,19678,2,Y,No,16,4,2,80,1,17,3,4,14,11,7,9
27,Yes,Travel_Rarely,674,Research & Development,14,2,Technical Degree,1,159,3,Male,52,2,2,Laboratory Technician,3,Married,3150,15689,1,Y,Yes,18,3,3,80,0,4,5,2,3,2,1,1
46,No,Non-Travel,1285,Sales,6,4,Marketing,1,160,4,Female,92,3,4,Manager,4,Divorced,15450,22789,7,Y,No,13,4,4,80,2,21,3,4,18,14,9,12
34,No,Travel_Rarely,591,Research & Development,18,3,Medical,1,161,1,Male,76,3,2,Healthcare Representative,1,Single,7850,18756,4,Y,Yes,17,3,1,80,1,10,4,3,8,6,4,5
30,Yes,Travel_Frequently,1398,Sales,26,2,Life Sciences,1,162,2,Female,49,2,2,Sales Executive,2,Single,4150,14789,5,Y,No,19,3,2,80,0,7,4,2,5,4,2,3
51,No,Travel_Rarely,516,Research & Development,9,5,Technical Degree,1,163,3,Male,88,4,4,Research Director,3,Married,16450,23567,3,Y,Yes,12,4,3,80,2,26,2,4,22,16,11,14
37,No,Travel_Frequently,1176,Human Resources,21,4,Human Resources,1,164,4,Female,67,3,3,Human Resources,4,Divorced,8850,19867,1,Y,No,15,3,4,80,1,13,3,3,10,8,5,7
28,Yes,Non-Travel,695,Research & Development,15,1,Life Sciences,1,165,1,Male,54,2,1,Research Scientist,1,Single,2950,15789,2,Y,Yes,20,4,1,80,0,5,4,2,3,2,1,1
43,No,Travel_Rarely,1289,Sales,7,4,Marketing,1,166,2,Female,91,4,4,Sales Executive,2,Married,13850,22678,6,Y,No,14,4,2,80,3,18,3,4,15,12,8,10
32,No,Travel_Frequently,573,Research & Development,20,3,Medical,1,167,3,Male,76,3,3,Manufacturing Director,3,Single,7250,18956,3,Y,Yes,16,3,3,80,1,8,5,3,6,4,2,3
29,Yes,Travel_Rarely,1387,Sales,28,2,Marketing,1,168,4,Female,48,2,1,Sales Representative,4,Single,3650,14689,7,Y,No,18,3,4,80,0,6,3,2,4,3,1,2
55,No,Non-Travel,525,Research & Development,8,5,Life Sciences,1,169,1,Male,92,3,5,Healthcare Representative,1,Divorced,17850,24678,4,Y,Yes,11,4,1,80,2,32,2,4,28,20,15,18
38,No,Travel_Rarely,1168,Human Resources,22,4,Human Resources,1,170,2,Female,68,4,2,Human Resources,2,Single,9450,19867,1,Y,No,17,4,2,80,1,14,4,3,11,8,5,7
25,Yes,Travel_Frequently,685,Research & Development,16,2,Technical Degree,1,171,3,Male,53,2,1,Laboratory Technician,3,Married,2850,15789,3,Y,Yes,21,4,3,80,0,2,5,2,1,0,0,0
48,No,Travel_Rarely,1278,Sales,5,4,Marketing,1,172,4,Female,90,3,4,Manager,4,Divorced,16250,23789,5,Y,No,12,4,4,80,3,23,3,4,19,15,10,13
35,No,Travel_Frequently,679,Research & Development,19,3,Medical,1,173,1,Male,74,4,3,Research Scientist,1,Single,6850,17896,2,Y,Yes,15,4,1,80,1,11,4,3,9,7,4,6
31,Yes,Non-Travel,1396,Sales,27,1,Life Sciences,1,174,2,Female,46,2,2,Sales Executive,2,Single,3850,14789,6,Y,No,19,3,2,80,0,8,4,2,6,4,2,3
44,No,Travel_Rarely,498,Research & Development,10,4,Technical Degree,1,175,3,Male,87,3,4,Healthcare Representative,3,Married,12450,21567,4,Y,Yes,14,3,3,80,2,19,2,3,16,12,7,10
33,No,Travel_Frequently,1175,Human Resources,23,3,Human Resources,1,176,4,Female,66,3,2,Human Resources,4,Single,7650,18756,1,Y,No,16,3,4,80,1,9,3,4,7,5,3,4
28,Yes,Travel_Rarely,691,Research & Development,17,2,Life Sciences,1,177,1,Male,55,2,1,Research Scientist,1,Married,3250,15689,1,Y,Yes,18,3,1,80,0,5,5,2,3,2,1,1
52,No,Non-Travel,1287,Sales,6,5,Marketing,1,178,2,Female,93,4,5,Sales Executive,2,Divorced,17250,24789,7,Y,No,13,4,2,80,3,29,3,4,25,19,14,17
39,No,Travel_Rarely,567,Research & Development,21,4,Medical,1,179,3,Male,78,3,3,Manufacturing Director,3,Single,8450,18956,3,Y,Yes,17,3,3,80,1,15,4,3,12,9,6,8
26,Yes,Travel_Frequently,1389,Sales,29,2,Marketing,1,180,4,Female,47,2,1,Sales Representative,4,Single,3250,14689,5,Y,No,20,4,4,80,0,3,3,2,2,1,0,1
49,No,Travel_Rarely,516,Research & Development,11,4,Life Sciences,1,181,1,Male,89,4,4,Research Director,1,Married,15650,22568,6,Y,Yes,12,4,1,80,2,24,3,4,20,15,10,13
36,No,Travel_Frequently,1178,Human Resources,24,3,Human Resources,1,182,2,Female,67,3,3,Manager,2,Divorced,9250,19867,2,Y,No,15,3,2,80,1,12,4,3,9,7,4,6
32,Yes,Non-Travel,693,Research & Development,16,1,Technical Degree,1,183,3,Male,56,2,1,Laboratory Technician,3,Single,3450,15789,1,Y,Yes,19,3,3,80,0,8,4,2,6,4,2,3
45,No,Travel_Rarely,1276,Sales,7,4,Marketing,1,184,4,Female,91,3,4,Sales Executive,4,Married,13650,21678,4,Y,No,14,4,4,80,2,20,3,4,17,13,8,11
33,No,Travel_Frequently,678,Research & Development,20,3,Medical,1,185,1,Male,75,4,2,Healthcare Representative,1,Single,7450,18756,3,Y,Yes,16,4,1,80,1,9,5,3,7,5,3,4
29,Yes,Travel_Rarely,1385,Sales,28,2,Life Sciences,1,186,2,Female,48,2,2,Sales Representative,2,Married,3750,14789,6,Y,No,18,3,2,80,0,6,4,2,4,3,1,2
54,No,Non-Travel,523,Research & Development,9,5,Technical Degree,1,187,3,Male,90,3,5,Manufacturing Director,3,Divorced,16850,23678,5,Y,Yes,11,4,3,80,3,31,2,4,27,19,14,17
41,No,Travel_Rarely,1187,Human Resources,22,4,Human Resources,1,188,4,Female,69,4,3,Human Resources,4,Single,10650,19678,1,Y,No,17,4,4,80,1,17,3,4,14,11,7,9
27,Yes,Travel_Frequently,674,Research & Development,15,2,Life Sciences,1,189,1,Male,52,2,1,Research Scientist,1,Single,2850,15689,2,Y,Yes,20,4,1,80,0,4,5,2,3,2,1,1
46,No,Travel_Rarely,1285,Sales,5,4,Marketing,1,190,2,Female,92,3,4,Manager,2,Married,15250,22789,7,Y,No,13,4,2,80,2,21,3,4,18,14,9,12
34,No,Travel_Frequently,591,Research & Development,19,3,Medical,1,191,3,Male,76,3,2,Research Scientist,3,Divorced,6850,17896,4,Y,Yes,15,3,3,80,1,10,4,3,8,6,4,5
30,Yes,Non-Travel,1398,Sales,27,1,Marketing,1,192,4,Female,49,2,1,Sales Executive,4,Single,4350,14789,5,Y,No,19,3,4,80,0,7,3,2,5,4,2,3
51,No,Travel_Rarely,516,Research & Development,8,5,Life Sciences,1,193,1,Male,88,4,4,Healthcare Representative,1,Married,16250,23567,3,Y,Yes,12,4,1,80,2,26,2,4,22,16,11,14
37,No,Travel_Frequently,1176,Human Resources,21,4,Human Resources,1,194,2,Female,67,3,3,Human Resources,2,Single,8650,19867,1,Y,No,16,3,2,80,1,13,4,3,10,8,5,7
28,Yes,Travel_Rarely,695,Research & Development,14,2,Technical Degree,1,195,3,Male,54,2,2,Laboratory Technician,3,Married,3150,15789,2,Y,Yes,18,3,3,80,0,5,5,2,3,2,1,1
43,No,Non-Travel,1289,Sales,6,4,Marketing,1,196,4,Female,91,4,4,Sales Executive,4,Divorced,14450,22678,6,Y,No,14,4,4,80,3,18,3,4,15,12,8,10
32,No,Travel_Rarely,573,Research & Development,18,3,Medical,1,197,1,Male,76,3,3,Manufacturing Director,1,Single,7650,18956,2,Y,Yes,17,3,1,80,1,8,4,3,6,4,2,3
29,Yes,Travel_Frequently,1387,Sales,26,2,Life Sciences,1,198,2,Female,48,2,1,Sales Representative,2,Single,3450,14689,7,Y,No,20,4,2,80,0,6,3,2,4,3,1,2
55,No,Travel_Rarely,525,Research & Development,10,5,Technical Degree,1,199,3,Male,92,3,5,Research Director,3,Married,17850,24678,4,Y,Yes,11,4,3,80,2,32,2,4,28,20,15,18
38,No,Travel_Frequently,1168,Human Resources,23,4,Human Resources,1,200,4,Female,68,4,2,Manager,4,Divorced,11450,19867,1,Y,No,15,4,4,80,1,14,3,4,11,8,5,7
25,Yes,Non-Travel,685,Research & Development,17,1,Life Sciences,1,201,1,Male,53,2,1,Research Scientist,1,Single,2750,15789,3,Y,Yes,21,4,1,80,0,2,4,2,1,0,0,0
48,No,Travel_Rarely,1278,Sales,4,4,Marketing,1,202,2,Female,90,3,4,Manager,2,Married,16450,22789,5,Y,No,12,4,2,80,2,23,3,4,19,15,10,13
35,No,Travel_Frequently,679,Research & Development,20,3,Medical,1,203,3,Male,74,4,3,Healthcare Representative,3,Single,7850,18756,4,Y,Yes,16,4,3,80,1,11,4,3,9,7,4,6
31,Yes,Travel_Rarely,1396,Sales,28,2,Life Sciences,1,204,4,Female,46,2,1,Sales Representative,4,Divorced,3650,14789,6,Y,No,19,3,4,80,0,8,3,2,6,4,2,3
44,No,Non-Travel,498,Research & Development,9,4,Technical Degree,1,205,1,Male,87,3,4,Manufacturing Director,1,Married,13850,21567,3,Y,Yes,14,3,1,80,2,19,2,3,16,12,7,10
33,No,Travel_Frequently,1175,Human Resources,22,3,Human Resources,1,206,2,Female,66,3,2,Human Resources,2,Single,7450,18756,1,Y,No,17,3,2,80,1,9,4,3,7,5,3,4
28,Yes,Travel_Rarely,691,Research & Development,16,1,Life Sciences,1,207,3,Male,55,2,1,Research Scientist,3,Married,3050,15689,2,Y,Yes,18,3,3,80,0,5,5,2,3,2,1,1
52,No,Travel_Rarely,1287,Sales,7,5,Marketing,1,208,4,Female,93,4,5,Sales Executive,4,Divorced,16850,24789,7,Y,No,13,4,4,80,3,29,3,4,25,19,14,17
39,No,Travel_Frequently,567,Research & Development,19,4,Medical,1,209,1,Male,78,3,3,Research Scientist,1,Single,6850,18956,3,Y,Yes,15,3,1,80,1,15,4,3,12,9,6,8
26,Yes,Non-Travel,1389,Sales,27,2,Marketing,1,210,2,Female,47,2,2,Sales Representative,2,Single,3450,14689,5,Y,No,20,4,2,80,0,3,4,2,2,1,0,1
49,No,Travel_Rarely,516,Research & Development,8,4,Life Sciences,1,211,3,Male,89,4,4,Healthcare Representative,3,Married,15250,22568,4,Y,Yes,12,4,3,80,2,24,3,4,20,15,10,13
36,No,Travel_Frequently,1178,Human Resources,21,3,Human Resources,1,212,4,Female,67,3,3,Manager,4,Single,9650,19867,2,Y,No,16,3,4,80,1,12,3,3,9,7,4,6
32,Yes,Travel_Rarely,693,Research & Development,15,2,Technical Degree,1,213,1,Male,56,2,1,Laboratory Technician,1,Single,3250,15789,1,Y,Yes,19,3,1,80,0,8,5,2,6,4,2,3
45,No,Non-Travel,1276,Sales,6,4,Marketing,1,214,2,Female,91,3,4,Sales Executive,2,Divorced,14850,21678,6,Y,No,14,4,2,80,2,20,3,4,17,13,8,11
33,No,Travel_Rarely,678,Research & Development,18,3,Medical,1,215,3,Male,75,4,2,Manufacturing Director,3,Married,6450,17896,3,Y,Yes,17,4,3,80,1,9,4,3,7,5,3,4
29,Yes,Travel_Frequently,1385,Sales,26,1,Life Sciences,1,216,4,Female,48,2,1,Sales Representative,4,Single,3850,14789,7,Y,No,18,3,4,80,0,6,3,2,4,3,1,2
54,No,Travel_Rarely,523,Research & Development,10,5,Technical Degree,1,217,1,Male,90,3,5,Research Director,1,Married,17650,23678,5,Y,Yes,11,4,1,80,3,31,2,4,27,19,14,17
41,No,Travel_Frequently,1187,Human Resources,23,4,Human Resources,1,218,2,Female,69,4,3,Human Resources,2,Divorced,10250,19678,2,Y,No,15,4,2,80,1,17,3,4,14,11,7,9
27,Yes,Non-Travel,674,Research & Development,17,2,Life Sciences,1,219,3,Male,52,2,1,Research Scientist,3,Single,2750,15689,1,Y,Yes,20,4,3,80,0,4,4,2,3,2,1,1
46,No,Travel_Rarely,1285,Sales,5,4,Marketing,1,220,4,Female,92,3,4,Manager,4,Married,15650,22789,4,Y,No,13,4,4,80,2,21,3,4,18,14,9,12
34,No,Travel_Frequently,591,Research & Development,20,3,Medical,1,221,1,Male,76,3,2,Healthcare Representative,1,Single,7250,17896,3,Y,Yes,16,3,1,80,1,10,5,3,8,6,4,5
30,Yes,Travel_Rarely,1398,Sales,28,2,Marketing,1,222,2,Female,49,2,2,Sales Executive,2,Married,4150,14789,6,Y,No,19,3,2,80,0,7,4,2,5,4,2,3
51,No,Non-Travel,516,Research & Development,11,5,Life Sciences,1,223,3,Male,88,4,4,Research Director,3,Divorced,16450,23567,5,Y,Yes,12,4,3,80,2,26,2,4,22,16,11,14
37,No,Travel_Rarely,1176,Human Resources,24,4,Human Resources,1,224,4,Female,67,3,3,Human Resources,4,Single,8450,19867,1,Y,No,17,3,4,80,1,13,3,3,10,8,5,7
28,Yes,Travel_Frequently,695,Research & Development,16,1,Technical Degree,1,225,1,Male,54,2,1,Laboratory Technician,1,Single,2850,15789,2,Y,Yes,18,3,1,80,0,5,5,2,3,2,1,1
43,No,Travel_Rarely,1289,Sales,7,4,Marketing,1,226,2,Female,91,4,4,Sales Executive,2,Married,13450,22678,7,Y,No,14,4,2,80,3,18,3,4,15,12,8,10
32,No,Travel_Frequently,573,Research & Development,19,3,Medical,1,227,3,Male,76,3,3,Research Scientist,3,Divorced,6850,18956,4,Y,Yes,15,3,3,80,1,8,4,3,6,4,2,3
29,Yes,Non-Travel,1387,Sales,27,2,Life Sciences,1,228,4,Female,48,2,1,Sales Representative,4,Single,3250,14689,5,Y,No,20,4,4,80,0,6,3,2,4,3,1,2
55,No,Travel_Rarely,525,Research & Development,9,5,Technical Degree,1,229,1,Male,92,3,5,Manufacturing Director,1,Married,18250,24678,3,Y,Yes,11,4,1,80,2,32,2,4,28,20,15,18
38,No,Travel_Frequently,1168,Human Resources,22,4,Human Resources,1,230,2,Female,68,4,2,Manager,2,Single,9850,19867,1,Y,No,16,4,2,80,1,14,4,3,11,8,5,7
25,Yes,Travel_Rarely,685,Research & Development,14,2,Life Sciences,1,231,3,Male,53,2,2,Research Scientist,3,Married,2950,15789,2,Y,Yes,21,4,3,80,0,2,5,2,1,0,0,0
48,No,Non-Travel,1278,Sales,6,4,Marketing,1,232,4,Female,90,3,4,Sales Executive,4,Divorced,15850,23789,6,Y,No,12,4,4,80,3,23,3,4,19,15,10,13
35,No,Travel_Rarely,679,Research & Development,21,3,Medical,1,233,1,Male,74,4,3,Healthcare Representative,1,Single,8250,18756,2,Y,Yes,17,4,1,80,1,11,3,3,9,7,4,6
31,Yes,Travel_Frequently,1396,Sales,29,1,Marketing,1,234,2,Female,46,2,1,Sales Representative,2,Single,3450,14789,7,Y,No,18,3,2,80,0,8,4,2,6,4,2,3
44,No,Travel_Rarely,498,Research & Development,8,4,Life Sciences,1,235,3,Male,87,3,4,Manufacturing Director,3,Married,12650,21567,4,Y,Yes,14,3,3,80,2,19,2,3,16,12,7,10
33,No,Travel_Frequently,1175,Human Resources,20,3,Human Resources,1,236,4,Female,66,3,2,Human Resources,4,Divorced,7850,18756,1,Y,No,15,3,4,80,1,9,3,4,7,5,3,4
28,Yes,Non-Travel,691,Research & Development,15,2,Technical Degree,1,237,1,Male,55,2,1,Laboratory Technician,1,Single,3150,15689,1,Y,Yes,19,3,1,80,0,5,4,2,3,2,1,1
52,No,Travel_Rarely,1287,Sales,5,5,Marketing,1,238,2,Female,93,4,5,Manager,2,Married,17250,24789,5,Y,No,13,4,2,80,3,29,3,4,25,19,14,17
39,No,Travel_Frequently,567,Research & Development,18,4,Medical,1,239,3,Male,78,3,3,Research Scientist,3,Single,7450,18956,3,Y,Yes,16,3,3,80,1,15,5,3,12,9,6,8
26,Yes,Travel_Rarely,1389,Sales,26,2,Life Sciences,1,240,4,Female,47,2,2,Sales Executive,4,Married,3650,14689,6,Y,No,20,4,4,80,0,3,3,2,2,1,0,1
49,No,Non-Travel,516,Research & Development,10,4,Technical Degree,1,241,1,Male,89,4,4,Healthcare Representative,1,Divorced,15450,22568,2,Y,Yes,12,4,1,80,2,24,3,4,20,15,10,13
36,No,Travel_Rarely,1178,Human Resources,23,3,Human Resources,1,242,2,Female,67,3,3,Manager,2,Single,9250,19867,1,Y,No,17,3,2,80,1,12,4,3,9,7,4,6
32,Yes,Travel_Frequently,693,Research & Development,17,1,Life Sciences,1,243,3,Male,56,2,1,Research Scientist,3,Single,3850,15789,3,Y,Yes,18,3,3,80,0,8,5,2,6,4,2,3
45,No,Travel_Rarely,1276,Sales,7,4,Marketing,1,244,4,Female,91,3,4,Sales Executive,4,Married,14250,21678,7,Y,No,14,4,4,80,2,20,3,4,17,13,8,11
33,No,Travel_Frequently,678,Research & Development,19,3,Medical,1,245,1,Male,75,4,2,Manufacturing Director,1,Divorced,6650,17896,4,Y,Yes,15,4,1,80,1,9,4,3,7,5,3,4
29,Yes,Non-Travel,1385,Sales,27,2,Marketing,1,246,2,Female,48,2,1,Sales Representative,2,Single,3450,14789,5,Y,No,19,3,2,80,0,6,3,2,4,3,1,2
54,No,Travel_Rarely,523,Research & Development,9,5,Life Sciences,1,247,3,Male,90,3,5,Research Director,3,Married,17850,23678,6,Y,Yes,11,4,3,80,3,31,2,4,27,19,14,17
41,No,Travel_Frequently,1187,Human Resources,21,4,Human Resources,1,248,4,Female,69,4,3,Human Resources,4,Single,10450,19678,2,Y,No,16,4,4,80,1,17,3,4,14,11,7,9
27,Yes,Travel_Rarely,674,Research & Development,16,2,Technical Degree,1,249,1,Male,52,2,2,Laboratory Technician,1,Married,2950,15689,1,Y,Yes,20,4,1,80,0,4,5,2,3,2,1,1
46,No,Non-Travel,1285,Sales,6,4,Marketing,1,250,2,Female,92,3,4,Manager,2,Divorced,15250,22789,4,Y,No,13,4,2,80,2,21,3,4,18,14,9,12
34,No,Travel_Rarely,591,Research & Development,18,3,Medical,1,251,3,Male,76,3,2,Healthcare Representative,3,Single,7650,17896,3,Y,Yes,17,3,3,80,1,10,4,3,8,6,4,5
30,Yes,Travel_Frequently,1398,Sales,25,1,Life Sciences,1,252,4,Female,49,2,1,Sales Executive,4,Single,4350,14789,7,Y,No,18,3,4,80,0,7,4,2,5,4,2,3
51,No,Travel_Rarely,516,Research & Development,11,5,Technical Degree,1,253,1,Male,88,4,4,Research Director,1,Married,16650,23567,5,Y,Yes,12,4,1,80,2,26,2,4,22,16,11,14
37,No,Travel_Frequently,1176,Human Resources,24,4,Human Resources,1,254,2,Female,67,3,3,Human Resources,2,Divorced,8650,19867,1,Y,No,15,3,2,80,1,13,3,3,10,8,5,7
28,Yes,Non-Travel,695,Research & Development,13,2,Life Sciences,1,255,3,Male,54,2,1,Research Scientist,3,Single,2750,15789,2,Y,Yes,21,4,3,80,0,5,4,2,3,2,1,1
43,No,Travel_Rarely,1289,Sales,5,4,Marketing,1,256,4,Female,91,4,4,Sales Executive,4,Married,13850,22678,3,Y,No,14,4,4,80,3,18,3,4,15,12,8,10
32,No,Travel_Frequently,573,Research & Development,20,3,Medical,1,257,1,Male,76,3,3,Manufacturing Director,1,Single,7050,18956,4,Y,Yes,16,3,1,80,1,8,5,3,6,4,2,3
29,Yes,Travel_Rarely,1387,Sales,28,2,Marketing,1,258,2,Female,48,2,2,Sales Representative,2,Married,3750,14689,6,Y,No,19,3,2,80,0,6,3,2,4,3,1,2
55,No,Non-Travel,525,Research & Development,8,5,Life Sciences,1,259,3,Male,92,3,5,Healthcare Representative,3,Divorced,18050,24678,2,Y,Yes,11,4,3,80,2,32,2,4,28,20,15,18
38,No,Travel_Rarely,1168,Human Resources,22,4,Human Resources,1,260,4,Female,68,4,2,Manager,4,Single,9650,19867,1,Y,No,17,4,4,80,1,14,4,3,11,8,5,7
25,Yes,Travel_Frequently,685,Research & Development,15,1,Technical Degree,1,261,1,Male,53,2,1,Laboratory Technician,1,Single,2850,15789,3,Y,Yes,20,4,1,80,0,2,5,2,1,0,0,0
48,No,Travel_Rarely,1278,Sales,7,4,Marketing,1,262,2,Female,90,3,4,Sales Executive,2,Divorced,16250,23789,7,Y,No,12,4,2,80,3,23,3,4,19,15,10,13
35,No,Travel_Frequently,679,Research & Development,19,3,Medical,1,263,3,Male,74,4,3,Research Scientist,3,Married,7850,18756,4,Y,Yes,15,4,3,80,1,11,3,3,9,7,4,6
31,Yes,Non-Travel,1396,Sales,27,2,Life Sciences,1,264,4,Female,46,2,1,Sales Representative,4,Single,3250,14789,5,Y,No,18,3,4,80,0,8,4,2,6,4,2,3
44,No,Travel_Rarely,498,Research & Development,10,4,Technical Degree,1,265,1,Male,87,3,4,Healthcare Representative,1,Married,12850,21567,6,Y,Yes,14,3,1,80,2,19,2,3,16,12,7,10
33,No,Travel_Frequently,1175,Human Resources,23,3,Human Resources,1,266,2,Female,66,3,2,Human Resources,2,Single,7250,18756,1,Y,No,16,3,2,80,1,9,4,3,7,5,3,4
28,Yes,Travel_Rarely,691,Research & Development,16,2,Life Sciences,1,267,3,Male,55,2,2,Research Scientist,3,Divorced,3250,15689,2,Y,Yes,19,3,3,80,0,5,5,2,3,2,1,1
52,No,Non-Travel,1287,Sales,6,5,Marketing,1,268,4,Female,93,4,5,Manager,4,Married,17450,24789,4,Y,No,13,4,4,80,3,29,3,4,25,19,14,17
39,No,Travel_Rarely,567,Research & Development,21,4,Medical,1,269,1,Male,78,3,3,Manufacturing Director,1,Single,8250,18956,3,Y,Yes,17,3,1,80,1,15,4,3,12,9,6,8
26,Yes,Travel_Frequently,1389,Sales,29,1,Marketing,1,270,2,Female,47,2,1,Sales Executive,2,Single,3450,14689,7,Y,No,20,4,2,80,0,3,3,2,2,1,0,1
49,No,Travel_Rarely,516,Research & Development,9,4,Life Sciences,1,271,3,Male,89,4,4,Research Director,3,Married,15650,22568,5,Y,Yes,12,4,3,80,2,24,3,4,20,15,10,13
36,No,Travel_Frequently,1178,Human Resources,22,3,Human Resources,1,272,4,Female,67,3,3,Human Resources,4,Divorced,9050,19867,2,Y,No,15,3,4,80,1,12,3,3,9,7,4,6
32,Yes,Non-Travel,693,Research & Development,14,2,Technical Degree,1,273,1,Male,56,2,1,Laboratory Technician,1,Single,3650,15789,1,Y,Yes,18,3,1,80,0,8,4,2,6,4,2,3
45,No,Travel_Rarely,1276,Sales,5,4,Marketing,1,274,2,Female,91,3,4,Sales Executive,2,Married,14450,21678,6,Y,No,14,4,2,80,2,20,3,4,17,13,8,11
33,No,Travel_Frequently,678,Research & Development,18,3,Medical,1,275,3,Male,75,4,2,Healthcare Representative,3,Single,6850,17896,3,Y,Yes,16,4,3,80,1,9,5,3,7,5,3,4
29,Yes,Travel_Rarely,1385,Sales,26,2,Life Sciences,1,276,4,Female,48,2,2,Sales Representative,4,Married,3850,14789,5,Y,No,19,3,4,80,0,6,3,2,4,3,1,2
54,No,Non-Travel,523,Research & Development,8,5,Technical Degree,1,277,1,Male,90,3,5,Manufacturing Director,1,Divorced,17250,23678,4,Y,Yes,11,4,1,80,3,31,2,4,27,19,14,17
41,No,Travel_Rarely,1187,Human Resources,20,4,Human Resources,1,278,2,Female,69,4,3,Manager,2,Single,10850,19678,1,Y,No,16,4,2,80,1,17,3,4,14,11,7,9
27,Yes,Travel_Frequently,674,Research & Development,17,1,Life Sciences,1,279,3,Male,52,2,1,Research Scientist,3,Single,2650,15689,2,Y,Yes,20,4,3,80,0,4,5,2,3,2,1,1
46,No,Travel_Rarely,1285,Sales,7,4,Marketing,1,280,4,Female,92,3,4,Sales Executive,4,Divorced,15450,22789,7,Y,No,13,4,4,80,2,21,3,4,18,14,9,12
34,No,Travel_Frequently,591,Research & Development,19,3,Medical,1,281,1,Male,76,3,2,Research Scientist,1,Married,7450,17896,4,Y,Yes,15,3,1,80,1,10,4,3,8,6,4,5
30,Yes,Non-Travel,1398,Sales,25,2,Marketing,1,282,2,Female,49,2,1,Sales Representative,2,Single,4150,14789,6,Y,No,18,3,2,80,0,7,4,2,5,4,2,3
51,No,Travel_Rarely,516,Research & Development,10,5,Life Sciences,1,283,3,Male,88,4,4,Healthcare Representative,3,Married,16850,23567,3,Y,Yes,12,4,3,80,2,26,2,4,22,16,11,14
37,No,Travel_Frequently,1176,Human Resources,23,4,Human Resources,1,284,4,Female,67,3,3,Human Resources,4,Single,8450,19867,1,Y,No,17,3,4,80,1,13,3,3,10,8,5,7
28,Yes,Travel_Rarely,695,Research & Development,15,2,Technical Degree,1,285,1,Male,54,2,2,Laboratory Technician,1,Married,2950,15789,2,Y,Yes,19,3,1,80,0,5,5,2,3,2,1,1
43,No,Non-Travel,1289,Sales,6,4,Marketing,1,286,2,Female,91,4,4,Manager,2,Divorced,14650,22678,5,Y,No,14,4,2,80,3,18,3,4,15,12,8,10
32,No,Travel_Rarely,573,Research & Development,18,3,Medical,1,287,3,Male,76,3,3,Manufacturing Director,3,Single,7250,18956,2,Y,Yes,17,3,3,80,1,8,4,3,6,4,2,3
29,Yes,Travel_Frequently,1387,Sales,27,1,Life Sciences,1,288,4,Female,48,2,1,Sales Executive,4,Single,3650,14689,7,Y,No,20,4,4,80,0,6,3,2,4,3,1,2
55,No,Travel_Rarely,525,Research & Development,9,5,Technical Degree,1,289,1,Male,92,3,5,Research Director,1,Married,18250,24678,6,Y,Yes,11,4,1,80,2,32,2,4,28,20,15,18
38,No,Travel_Frequently,1168,Human Resources,21,4,Human Resources,1,290,2,Female,68,4,2,Human Resources,2,Divorced,9250,19867,1,Y,No,15,3,2,80,1,14,4,3,11,8,5,7
25,Yes,Non-Travel,685,Research & Development,16,1,Life Sciences,1,291,3,Male,53,2,1,Research Scientist,3,Single,2750,15789,3,Y,Yes,21,4,3,80,0,2,4,2,1,0,0,0
48,No,Travel_Rarely,1278,Sales,5,4,Marketing,1,292,4,Female,90,3,4,Sales Executive,4,Married,15650,23789,4,Y,No,12,4,4,80,3,23,3,4,19,15,10,13
35,No,Travel_Frequently,679,Research & Development,20,3,Medical,1,293,1,Male,74,4,3,Healthcare Representative,1,Single,7650,18756,3,Y,Yes,16,4,1,80,1,11,3,3,9,7,4,6
31,Yes,Travel_Rarely,1396,Sales,28,2,Life Sciences,1,294,2,Female,46,2,2,Sales Representative,2,Married,3450,14789,5,Y,No,19,3,2,80,0,8,4,2,6,4,2,3
44,No,Non-Travel,498,Research & Development,11,4,Technical Degree,1,295,3,Male,87,3,4,Manufacturing Director,3,Divorced,12450,21567,2,Y,Yes,14,3,3,80,2,19,2,3,16,12,7,10
33,No,Travel_Rarely,1175,Human Resources,24,3,Human Resources,1,296,4,Female,66,3,2,Manager,4,Single,10250,18756,1,Y,No,16,3,4,80,1,9,3,4,7,5,3,4
28,Yes,Travel_Frequently,691,Research & Development,17,2,Life Sciences,1,297,1,Male,55,2,1,Research Scientist,1,Single,3050,15689,1,Y,Yes,18,3,1,80,0,5,5,2,3,2,1,1
52,No,Travel_Rarely,1287,Sales,7,5,Marketing,1,298,2,Female,93,4,5,Sales Executive,2,Married,16850,24789,6,Y,No,13,4,2,80,3,29,3,4,25,19,14,17
39,No,Travel_Frequently,567,Research & Development,22,4,Medical,1,299,3,Male,78,3,3,Research Scientist,3,Divorced,7850,18956,4,Y,Yes,15,3,3,80,1,15,4,3,12,9,6,8
26,Yes,Non-Travel,1389,Sales,29,1,Marketing,1,300,4,Female,47,2,1,Sales Representative,4,Single,3250,14689,6,Y,No,20,4,4,80,0,3,3,2,2,1,0,1
29,No,Travel_Rarely,1450,Sales,5,4,Marketing,1,1001,3,Female,75,3,2,Sales Executive,4,Single,6200,15000,2,Y,Yes,15,3,3,80,1,8,2,3,5,3,1,4
35,Yes,Travel_Frequently,890,Research & Development,12,3,Life Sciences,1,1002,2,Male,62,2,3,Research Scientist,2,Married,8500,18500,4,Y,No,12,4,2,80,2,12,3,2,8,5,2,6
42,No,Non-Travel,1200,Human Resources,3,5,Human Resources,1,1003,4,Female,88,4,4,Manager,3,Divorced,14000,22000,1,Y,No,18,3,4,80,0,18,4,3,15,8,5,12
26,No,Travel_Rarely,650,Sales,8,2,Technical Degree,1,1004,3,Male,45,3,1,Sales Representative,3,Married,3800,12000,0,Y,Yes,13,3,2,80,1,4,2,4,3,2,0,2
38,No,Travel_Frequently,1350,Research & Development,15,4,Medical,1,1005,4,Female,92,3,3,Healthcare Representative,4,Single,9200,19500,3,Y,No,16,3,3,80,1,14,3,2,10,7,3,8
33,Yes,Travel_Rarely,720,Sales,6,3,Marketing,1,1006,1,Male,55,2,2,Sales Executive,2,Divorced,5500,14500,5,Y,Yes,11,3,1,80,2,9,4,3,7,4,2,5
41,No,Non-Travel,1100,Research & Development,20,4,Life Sciences,1,1007,3,Female,78,4,4,Manager,4,Married,16500,25000,2,Y,No,20,4,4,80,0,19,2,3,16,12,8,14
28,No,Travel_Rarely,580,Human Resources,4,3,Human Resources,1,1008,2,Male,48,2,2,Human Resources,2,Single,4200,11000,1,Y,No,14,3,3,80,1,6,3,2,5,3,1,3
45,No,Travel_Frequently,1400,Research & Development,18,5,Medical,1,1009,4,Female,95,3,4,Research Director,4,Divorced,18000,28000,6,Y,Yes,22,4,3,80,1,22,5,4,18,10,12,16
31,Yes,Travel_Rarely,800,Sales,9,2,Life Sciences,1,1010,3,Male,68,3,2,Sales Executive,3,Married,6800,16000,3,Y,No,13,3,2,80,2,8,2,3,6,4,1,4
37,No,Non-Travel,950,Research & Development,7,4,Technical Degree,1,1011,4,Female,72,4,3,Manufacturing Director,3,Single,11200,20500,4,Y,No,17,3,4,80,0,15,4,3,12,8,6,10
24,No,Travel_Rarely,420,Sales,2,1,Marketing,1,1012,2,Male,38,2,1,Sales Representative,2,Divorced,2800,9500,0,Y,Yes,12,3,2,80,1,2,1,3,2,1,0,1
50,No,Travel_Frequently,1500,Research & Development,25,4,Life Sciences,1,1013,3,Female,98,3,5,Research Director,4,Married,22000,30000,5,Y,No,25,4,4,80,1,28,6,4,25,15,18,22
32,Yes,Travel_Rarely,680,Human Resources,11,3,Human Resources,1,1014,2,Male,52,3,2,Human Resources,2,Single,4800,13000,2,Y,Yes,15,3,3,80,1,8,3,2,6,4,2,5
39,No,Non-Travel,1250,Sales,14,4,Medical,1,1015,4,Female,82,4,3,Manager,4,Divorced,13500,23500,3,Y,No,19,3,4,80,0,17,3,3,14,9,7,12
27,No,Travel_Rarely,550,Research & Development,5,2,Technical Degree,1,1016,3,Male,44,2,1,Research Scientist,2,Married,3600,10500,1,Y,No,11,3,2,80,2,5,2,3,4,3,1,3
44,No,Travel_Frequently,1420,Research & Development,22,5,Life Sciences,1,1017,4,Female,88,4,4,Manager,4,Single,17800,27000,7,Y,Yes,21,4,3,80,1,21,4,4,18,11,13,17
30,Yes,Travel_Rarely,750,Sales,8,3,Marketing,1,1018,2,Male,58,3,2,Sales Executive,3,Divorced,5800,15500,4,Y,No,14,3,2,80,2,7,3,2,5,3,1,4
46,No,Non-Travel,1180,Human Resources,16,4,Human Resources,1,1019,3,Female,75,3,3,Manager,3,Married,12800,21500,2,Y,No,18,3,3,80,0,24,5,3,20,12,10,18
25,No,Travel_Rarely,480,Research & Development,3,1,Medical,1,1020,4,Male,42,2,1,Laboratory Technician,2,Single,3200,8500,0,Y,Yes,13,3,3,80,1,3,2,2,3,2,0,2
52,No,Travel_Frequently,1600,Sales,28,4,Life Sciences,1,1021,3,Female,92,4,4,Manager,4,Divorced,19500,29500,6,Y,No,24,4,4,80,1,30,6,4,26,18,15,24
34,Yes,Travel_Rarely,820,Research & Development,10,3,Technical Degree,1,1022,2,Male,65,3,2,Research Scientist,3,Married,7200,17000,3,Y,Yes,16,3,2,80,2,11,3,3,8,5,3,7
40,No,Non-Travel,1080,Human Resources,12,4,Human Resources,1,1023,4,Female,78,4,3,Manager,4,Single,14200,24000,4,Y,No,20,3,4,80,0,18,4,3,15,10,8,14
28,No,Travel_Rarely,620,Sales,6,2,Marketing,1,1024,3,Male,48,2,2,Sales Executive,2,Divorced,4500,12500,1,Y,No,12,3,2,80,1,6,2,3,5,3,1,4
47,No,Travel_Frequently,1380,Research & Development,21,5,Medical,1,1025,4,Female,85,3,4,Research Director,4,Married,20000,31000,5,Y,Yes,23,4,3,80,1,25,5,4,22,13,16,20
33,Yes,Travel_Rarely,740,Sales,9,3,Life Sciences,1,1026,2,Male,55,3,2,Sales Executive,2,Single,6200,14800,2,Y,No,15,3,2,80,2,10,3,2,7,4,2,6
41,No,Non-Travel,1150,Research & Development,17,4,Technical Degree,1,1027,3,Female,82,4,3,Manufacturing Director,3,Divorced,15200,25500,4,Y,No,19,3,4,80,0,19,4,3,16,10,9,15
26,No,Travel_Rarely,450,Human Resources,4,2,Human Resources,1,1028,4,Male,40,2,2,Human Resources,2,Married,3500,10000,0,Y,Yes,11,3,3,80,1,4,2,2,4,2,1,3
49,No,Travel_Frequently,1480,Sales,26,4,Marketing,1,1029,3,Female,90,4,4,Manager,4,Single,18500,28500,6,Y,No,22,4,4,80,1,27,5,4,24,16,12,22
31,Yes,Travel_Rarely,780,Research & Development,8,3,Life Sciences,1,1030,2,Male,62,3,2,Research Scientist,3,Divorced,6800,16500,3,Y,Yes,14,3,2,80,2,9,3,3,7,4,2,6
38,No,Non-Travel,1020,Human Resources,13,4,Human Resources,1,1031,4,Female,75,3,3,Manager,3,Married,13200,22500,3,Y,No,18,3,3,80,0,16,4,3,13,8,6,12
23,No,Travel_Rarely,380,Sales,2,1,Technical Degree,1,1032,3,Male,35,2,1,Sales Representative,2,Single,2600,8000,0,Y,No,10,3,2,80,1,1,1,3,1,0,0,1
53,No,Travel_Frequently,1550,Research & Development,24,5,Medical,1,1033,4,Female,95,4,5,Research Director,4,Divorced,23500,32000,7,Y,Yes,26,4,4,80,1,31,6,4,28,20,22,26
35,Yes,Travel_Rarely,850,Sales,11,3,Marketing,1,1034,2,Male,58,3,2,Sales Executive,3,Married,7500,18000,4,Y,No,16,3,2,80,2,12,3,3,9,6,4,8
42,No,Non-Travel,1200,Research & Development,18,4,Life Sciences,1,1035,3,Female,82,4,3,Manufacturing Director,4,Single,16800,26500,5,Y,No,20,3,4,80,0,20,4,3,17,11,10,16
29,No,Travel_Rarely,650,Human Resources,7,2,Human Resources,1,1036,4,Male,48,2,2,Human Resources,3,Divorced,5200,13500,1,Y,Yes,13,3,3,80,1,7,3,2,6,4,2,5
48,No,Travel_Frequently,1450,Sales,23,4,Technical Degree,1,1037,3,Female,88,4,4,Manager,4,Married,19200,29000,6,Y,No,24,4,4,80,1,26,5,4,23,15,14,21
32,Yes,Travel_Rarely,720,Research & Development,9,3,Medical,1,1038,2,Male,55,3,2,Research Scientist,2,Single,6500,15500,2,Y,Yes,15,3,2,80,2,10,3,2,8,5,3,7
39,No,Non-Travel,1080,Human Resources,15,4,Human Resources,1,1039,4,Female,78,3,3,Manager,4,Divorced,14500,24500,4,Y,No,19,3,4,80,0,17,4,3,14,9,7,13
27,No,Travel_Rarely,520,Sales,5,2,Marketing,1,1040,3,Male,45,2,2,Sales Executive,2,Married,4200,11500,1,Y,No,12,3,2,80,1,5,2,3,4,3,1,3
45,No,Travel_Frequently,1400,Research & Development,20,5,Life Sciences,1,1041,4,Female,90,3,4,Research Director,4,Single,21000,30500,5,Y,Yes,23,4,3,80,1,23,5,4,20,12,15,19
30,Yes,Travel_Rarely,760,Sales,8,3,Technical Degree,1,1042,2,Male,58,3,2,Sales Executive,3,Divorced,6000,16000,3,Y,No,14,3,2,80,2,8,3,2,6,4,2,5
43,No,Non-Travel,1180,Research & Development,19,4,Medical,1,1043,3,Female,85,4,3,Manufacturing Director,3,Married,17200,27000,4,Y,No,21,3,4,80,0,21,4,3,18,11,12,17
26,No,Travel_Rarely,480,Human Resources,4,2,Human Resources,1,1044,4,Male,42,2,2,Human Resources,2,Single,3800,10500,0,Y,Yes,11,3,3,80,1,4,2,2,4,2,1,3
51,No,Travel_Frequently,1520,Sales,27,4,Marketing,1,1045,3,Female,92,4,4,Manager,4,Divorced,20500,31500,6,Y,No,25,4,4,80,1,29,5,4,26,17,16,24
34,Yes,Travel_Rarely,820,Research & Development,10,3,Life Sciences,1,1046,2,Male,62,3,2,Research Scientist,3,Single,7200,17500,3,Y,Yes,16,3,2,80,2,11,3,3,8,5,3,7
40,No,Non-Travel,1120,Human Resources,14,4,Human Resources,1,1047,4,Female,80,3,3,Manager,4,Married,15200,25000,4,Y,No,20,3,4,80,0,18,4,3,15,10,8,14
28,No,Travel_Rarely,580,Sales,6,2,Technical Degree,1,1048,3,Male,48,2,2,Sales Executive,2,Divorced,4800,13000,1,Y,No,13,3,2,80,1,6,2,3,5,3,1,4
46,No,Travel_Frequently,1420,Research & Development,22,5,Medical,1,1049,4,Female,88,3,4,Research Director,4,Single,22500,32500,5,Y,Yes,24,4,3,80,1,24,5,4,21,13,17,20
33,Yes,Travel_Rarely,780,Sales,9,3,Marketing,1,1050,2,Male,58,3,2,Sales Executive,3,Married,6800,16500,4,Y,No,15,3,2,80,2,10,3,2,7,4,2,6
41,No,Non-Travel,1160,Research & Development,16,4,Life Sciences,1,1051,3,Female,82,4,3,Manufacturing Director,3,Divorced,16500,26000,5,Y,No,19,3,4,80,0,19,4,3,16,10,9,15
25,No,Travel_Rarely,420,Human Resources,3,1,Human Resources,1,1052,4,Male,38,2,2,Human Resources,2,Single,3200,9500,0,Y,Yes,10,3,3,80,1,3,2,2,3,2,0,2
52,No,Travel_Frequently,1580,Sales,28,4,Technical Degree,1,1053,3,Female,95,4,4,Manager,4,Married,21500,33000,7,Y,No,26,4,4,80,1,30,6,4,27,18,20,25
36,Yes,Travel_Rarely,880,Research & Development,12,3,Medical,1,1054,2,Male,65,3,2,Research Scientist,2,Single,7800,18500,3,Y,Yes,17,3,2,80,2,13,3,3,10,6,4,9
44,No,Non-Travel,1220,Human Resources,20,4,Human Resources,1,1055,4,Female,85,3,3,Manager,4,Divorced,16800,27500,4,Y,No,22,3,4,80,0,22,4,3,19,12,11,18
29,No,Travel_Rarely,620,Sales,7,2,Marketing,1,1056,3,Male,52,2,2,Sales Executive,2,Married,5200,14000,1,Y,No,14,3,2,80,1,7,3,2,6,4,2,5
47,No,Travel_Frequently,1460,Research & Development,23,5,Life Sciences,1,1057,4,Female,90,3,4,Research Director,4,Single,23000,33500,6,Y,Yes,25,4,3,80,1,25,5,4,22,14,18,21
31,Yes,Travel_Rarely,740,Sales,8,3,Technical Degree,1,1058,2,Male,55,3,2,Sales Executive,3,Divorced,6200,15500,3,Y,No,15,3,2,80,2,9,3,2,7,4,2,6
38,No,Non-Travel,1040,Research & Development,13,4,Medical,1,1059,3,Female,78,4,3,Manufacturing Director,3,Married,14800,24500,4,Y,No,18,3,4,80,0,16,4,3,13,8,6,12
24,No,Travel_Rarely,400,Human Resources,2,1,Human Resources,1,1060,4,Male,35,2,2,Human Resources,2,Single,2800,8500,0,Y,Yes,11,3,3,80,1,2,1,3,2,1,0,1
50,No,Travel_Frequently,1500,Sales,25,4,Marketing,1,1061,3,Female,92,4,4,Manager,4,Divorced,20000,31000,6,Y,No,24,4,4,80,1,28,5,4,25,16,15,23
35,Yes,Travel_Rarely,850,Research & Development,11,3,Life Sciences,1,1062,2,Male,62,3,2,Research Scientist,3,Single,7500,17000,3,Y,Yes,16,3,2,80,2,12,3,3,9,5,3,8
42,No,Non-Travel,1180,Human Resources,17,4,Human Resources,1,1063,4,Female,82,3,3,Manager,4,Married,15500,25500,4,Y,No,20,3,4,80,0,20,4,3,17,11,9,16
27,No,Travel_Rarely,540,Sales,5,2,Technical Degree,1,1064,3,Male,45,2,2,Sales Executive,2,Divorced,4500,12000,1,Y,No,12,3,2,80,1,5,2,3,4,3,1,3
48,No,Travel_Frequently,1480,Research & Development,24,5,Medical,1,1065,4,Female,88,3,4,Research Director,4,Single,22000,32000,5,Y,Yes,24,4,3,80,1,26,5,4,23,13,16,21
32,Yes,Travel_Rarely,760,Sales,9,3,Marketing,1,1066,2,Male,58,3,2,Sales Executive,3,Married,6500,16000,4,Y,No,15,3,2,80,2,10,3,2,8,5,3,7
39,No,Non-Travel,1100,Research & Development,15,4,Life Sciences,1,1067,3,Female,80,4,3,Manufacturing Director,3,Divorced,15800,26000,5,Y,No,19,3,4,80,0,17,4,3,14,9,7,13
26,No,Travel_Rarely,460,Human Resources,4,2,Human Resources,1,1068,4,Male,40,2,2,Human Resources,2,Single,3600,10000,0,Y,Yes,11,3,3,80,1,4,2,2,4,2,1,3
53,No,Travel_Frequently,1600,Sales,29,4,Technical Degree,1,1069,3,Female,95,4,4,Manager,4,Married,22000,34000,7,Y,No,27,4,4,80,1,31,6,4,28,19,21,26
37,Yes,Travel_Rarely,920,Research & Development,12,3,Medical,1,1070,2,Male,68,3,2,Research Scientist,2,Single,8200,19000,3,Y,Yes,18,3,2,80,2,14,3,3,11,7,5,10
43,No,Non-Travel,1240,Human Resources,19,4,Human Resources,1,1071,4,Female,85,3,3,Manager,4,Divorced,17200,28000,4,Y,No,21,3,4,80,0,21,4,3,18,11,10,17
30,No,Travel_Rarely,680,Sales,8,2,Marketing,1,1072,3,Male,52,2,2,Sales Executive,2,Married,5800,15000,1,Y,No,14,3,2,80,1,8,3,2,7,4,2,6
49,No,Travel_Frequently,1520,Research & Development,26,5,Life Sciences,1,1073,4,Female,92,3,4,Research Director,4,Single,24000,34500,6,Y,Yes,26,4,3,80,1,27,5,4,24,15,19,22
34,Yes,Travel_Rarely,820,Sales,10,3,Technical Degree,1,1074,2,Male,62,3,2,Sales Executive,3,Divorced,7200,17500,4,Y,No,16,3,2,80,2,11,3,2,8,5,3,7
40,No,Non-Travel,1140,Research & Development,16,4,Medical,1,1075,3,Female,82,4,3,Manufacturing Director,3,Married,16200,26500,5,Y,No,18,3,4,80,0,18,4,3,15,10,8,14
25,No,Travel_Rarely,440,Human Resources,3,1,Human Resources,1,1076,4,Male,38,2,2,Human Resources,2,Single,3400,9000,0,Y,Yes,10,3,3,80,1,3,2,2,3,2,0,2
54,No,Travel_Frequently,1640,Sales,30,4,Marketing,1,1077,3,Female,98,4,4,Manager,4,Divorced,23000,35000,8,Y,No,28,4,4,80,1,32,6,4,29,20,22,27
38,Yes,Travel_Rarely,960,Research & Development,13,3,Life Sciences,1,1078,2,Male,72,3,2,Research Scientist,2,Single,8800,20000,3,Y,Yes,19,3,2,80,2,15,3,3,12,8,6,11
45,No,Non-Travel,1280,Human Resources,21,4,Human Resources,1,1079,4,Female,88,3,3,Manager,4,Married,18000,29000,4,Y,No,23,3,4,80,0,23,4,3,20,13,12,19
31,No,Travel_Rarely,720,Sales,9,2,Technical Degree,1,1080,3,Male,55,2,2,Sales Executive,2,Divorced,6200,16000,1,Y,No,15,3,2,80,1,9,3,2,8,5,3,7
46,No,Travel_Frequently,1440,Research & Development,22,5,Medical,1,1081,4,Female,90,3,4,Research Director,4,Single,23500,33000,6,Y,Yes,24,4,3,80,1,24,5,4,21,13,17,20
33,Yes,Travel_Rarely,800,Sales,10,3,Marketing,1,1082,2,Male,60,3,2,Sales Executive,3,Married,7000,17000,4,Y,No,16,3,2,80,2,10,3,2,8,5,3,7
41,No,Non-Travel,1160,Research & Development,17,4,Life Sciences,1,1083,3,Female,82,4,3,Manufacturing Director,3,Divorced,16800,26500,5,Y,No,19,3,4,80,0,19,4,3,16,10,9,15
28,No,Travel_Rarely,600,Human Resources,6,2,Human Resources,1,1084,4,Male,48,2,2,Human Resources,2,Single,4800,13500,0,Y,Yes,13,3,3,80,1,6,2,3,5,3,1,4
51,No,Travel_Frequently,1560,Sales,27,4,Technical Degree,1,1085,3,Female,95,4,4,Manager,4,Married,21000,32500,7,Y,No,25,4,4,80,1,29,5,4,26,17,16,24
36,Yes,Travel_Rarely,880,Research & Development,12,3,Medical,1,1086,2,Male,65,3,2,Research Scientist,3,Single,7800,18000,3,Y,Yes,17,3,2,80,2,13,3,3,10,6,4,9
42,No,Non-Travel,1200,Human Resources,18,4,Human Resources,1,1087,4,Female,85,3,3,Manager,4,Divorced,16500,27000,4,Y,No,20,3,4,80,0,20,4,3,17,11,10,16
29,No,Travel_Rarely,640,Sales,7,2,Marketing,1,1088,3,Male,52,2,2,Sales Executive,2,Married,5400,14500,1,Y,No,14,3,2,80,1,7,3,2,6,4,2,5
47,No,Travel_Frequently,1480,Research & Development,23,5,Life Sciences,1,1089,4,Female,92,3,4,Research Director,4,Single,24000,34000,6,Y,Yes,25,4,3,80,1,25,5,4,22,14,18,21
32,Yes,Travel_Rarely,780,Sales,9,3,Technical Degree,1,1090,2,Male,58,3,2,Sales Executive,3,Divorced,6800,16500,4,Y,No,15,3,2,80,2,9,3,2,7,4,2,6
39,No,Non-Travel,1080,Research & Development,15,4,Medical,1,1091,3,Female,78,4,3,Manufacturing Director,3,Married,15200,25000,5,Y,No,18,3,4,80,0,17,4,3,14,9,7,13
24,No,Travel_Rarely,420,Human Resources,2,1,Human Resources,1,1092,4,Male,35,2,2,Human Resources,2,Single,3000,8500,0,Y,Yes,11,3,3,80,1,2,1,3,2,1,0,1
52,No,Travel_Frequently,1580,Sales,28,4,Marketing,1,1093,3,Female,95,4,4,Manager,4,Divorced,21500,33000,7,Y,No,26,4,4,80,1,30,6,4,27,18,20,25
37,Yes,Travel_Rarely,920,Research & Development,13,3,Life Sciences,1,1094,2,Male,68,3,2,Research Scientist,2,Single,8200,19000,3,Y,Yes,18,3,2,80,2,14,3,3,11,7,5,10
44,No,Non-Travel,1260,Human Resources,20,4,Human Resources,1,1095,4,Female,88,3,3,Manager,4,Married,17500,28500,4,Y,No,22,3,4,80,0,22,4,3,19,12,11,18
30,No,Travel_Rarely,700,Sales,8,2,Technical Degree,1,1096,3,Male,55,2,2,Sales Executive,2,Divorced,6000,15500,1,Y,No,14,3,2,80,1,8,3,2,7,4,2,6
48,No,Travel_Frequently,1500,Research & Development,24,5,Medical,1,1097,4,Female,90,3,4,Research Director,4,Single,24500,34500,6,Y,Yes,24,4,3,80,1,26,5,4,23,13,16,21
35,Yes,Travel_Rarely,860,Sales,11,3,Marketing,1,1098,2,Male,62,3,2,Sales Executive,3,Married,7600,17500,4,Y,No,16,3,2,80,2,12,3,2,9,6,4,8
43,No,Non-Travel,1220,Research & Development,19,4,Life Sciences,1,1099,3,Female,85,4,3,Manufacturing Director,3,Divorced,17000,27000,5,Y,No,21,3,4,80,0,21,4,3,18,11,10,17
27,No,Travel_Rarely,520,Human Resources,5,2,Human Resources,1,1100,4,Male,45,2,2,Human Resources,2,Single,4000,11000,0,Y,Yes,12,3,3,80,1,5,2,2,4,3,1,3
49,No,Travel_Frequently,1540,Sales,25,4,Technical Degree,1,1101,3,Female,92,4,4,Manager,4,Married,20500,31500,7,Y,No,25,4,4,80,1,27,5,4,24,15,17,22
34,Yes,Travel_Rarely,840,Research & Development,10,3,Medical,1,1102,2,Male,62,3,2,Research Scientist,3,Single,7400,18000,3,Y,Yes,16,3,2,80,2,11,3,3,8,5,3,7
41,No,Non-Travel,1180,Human Resources,17,4,Human Resources,1,1103,4,Female,82,3,3,Manager,4,Divorced,16200,26000,4,Y,No,19,3,4,80,0,19,4,3,16,10,9,15
26,No,Travel_Rarely,480,Sales,4,2,Marketing,1,1104,3,Male,42,2,2,Sales Executive,2,Married,4200,12500,0,Y,No,11,3,2,80,1,4,2,3,3,2,0,2
53,No,Travel_Frequently,1620,Research & Development,29,5,Life Sciences,1,1105,4,Female,95,3,4,Research Director,4,Single,25000,35000,6,Y,Yes,27,4,3,80,1,31,6,4,28,16,20,25
38,Yes,Travel_Rarely,980,Sales,13,3,Technical Degree,1,1106,2,Male,72,3,2,Sales Executive,2,Divorced,8600,19500,3,Y,No,18,3,2,80,2,15,3,2,12,8,6,11
45,No,Non-Travel,1300,Human Resources,21,4,Human Resources,1,1107,4,Female,88,3,3,Manager,4,Married,18500,29500,4,Y,No,23,3,4,80,0,23,4,3,20,13,12,19
31,No,Travel_Rarely,740,Research & Development,9,2,Medical,1,1108,3,Male,58,2,2,Laboratory Technician,2,Single,6500,16500,1,Y,Yes,15,3,2,80,1,9,3,2,8,5,3,7
50,No,Travel_Frequently,1580,Sales,26,4,Marketing,1,1109,3,Female,95,4,4,Manager,4,Divorced,22000,33500,7,Y,No,26,4,4,80,1,28,5,4,25,17,19,23
33,Yes,Travel_Rarely,820,Research & Development,10,3,Life Sciences,1,1110,2,Male,60,3,2,Research Scientist,3,Married,7200,17000,4,Y,Yes,16,3,2,80,2,10,3,2,8,5,3,7
42,No,Non-Travel,1240,Human Resources,18,4,Human Resources,1,1111,4,Female,85,3,3,Manager,4,Single,17200,27500,5,Y,No,20,3,4,80,0,20,4,3,17,11,10,16
28,No,Travel_Rarely,620,Sales,6,2,Technical Degree,1,1112,3,Male,48,2,2,Sales Executive,2,Divorced,5200,14000,1,Y,No,13,3,2,80,1,6,2,3,5,3,1,4
46,No,Travel_Frequently,1460,Research & Development,22,5,Medical,1,1113,4,Female,90,3,4,Research Director,4,Married,24000,34000,6,Y,Yes,24,4,3,80,1,24,5,4,21,13,17,20
36,Yes,Travel_Rarely,900,Sales,12,3,Marketing,1,1114,2,Male,65,3,2,Sales Executive,3,Single,8000,18500,4,Y,No,17,3,2,80,2,13,3,2,10,6,4,9
40,No,Non-Travel,1120,Research & Development,16,4,Life Sciences,1,1115,3,Female,80,4,3,Manufacturing Director,3,Divorced,15800,25500,5,Y,No,18,3,4,80,0,18,4,3,15,10,8,14
25,No,Travel_Rarely,460,Human Resources,3,1,Human Resources,1,1116,4,Male,40,2,2,Human Resources,2,Married,3600,10500,0,Y,Yes,11,3,3,80,1,3,2,2,3,2,0,2
54,No,Travel_Frequently,1640,Sales,30,4,Technical Degree,1,1117,3,Female,98,4,4,Manager,4,Single,23500,35500,8,Y,No,28,4,4,80,1,32,6,4,29,20,22,27
39,Yes,Travel_Rarely,1000,Research & Development,15,3,Medical,1,1118,2,Male,75,3,2,Research Scientist,2,Divorced,9200,20500,3,Y,Yes,19,3,2,80,2,16,3,3,13,8,6,12
47,No,Non-Travel,1340,Human Resources,23,4,Human Resources,1,1119,4,Female,90,3,3,Manager,4,Married,19000,30000,4,Y,No,25,3,4,80,0,25,4,3,22,14,13,20
32,No,Travel_Rarely,760,Sales,9,2,Marketing,1,1120,3,Male,58,2,2,Sales Executive,2,Single,6800,17000,1,Y,No,15,3,2,80,1,9,3,2,8,5,3,7
51,No,Travel_Frequently,1600,Research & Development,27,5,Life Sciences,1,1121,4,Female,95,3,4,Research Director,4,Divorced,26000,36000,6,Y,Yes,27,4,3,80,1,29,5,4,26,15,21,24
37,Yes,Travel_Rarely,940,Sales,13,3,Technical Degree,1,1122,2,Male,70,3,2,Sales Executive,3,Married,8400,19000,4,Y,No,18,3,2,80,2,14,3,2,11,7,5,10
44,No,Non-Travel,1280,Research & Development,20,4,Medical,1,1123,3,Female,88,4,3,Manufacturing Director,3,Single,18200,28500,5,Y,No,22,3,4,80,0,22,4,3,19,12,11,18
29,No,Travel_Rarely,660,Human Resources,7,2,Human Resources,1,1124,4,Male,52,2,2,Human Resources,2,Divorced,5600,15000,0,Y,Yes,14,3,3,80,1,7,3,2,6,4,2,5
48,No,Travel_Frequently,1520,Sales,24,4,Marketing,1,1125,3,Female,92,4,4,Manager,4,Married,21500,32000,7,Y,No,24,4,4,80,1,26,5,4,23,15,18,21
35,Yes,Travel_Rarely,880,Research & Development,11,3,Life Sciences,1,1126,2,Male,65,3,2,Research Scientist,3,Single,7800,18000,3,Y,Yes,16,3,2,80,2,12,3,3,9,5,3,8
43,No,Non-Travel,1260,Human Resources,19,4,Human Resources,1,1127,4,Female,85,3,3,Manager,4,Divorced,17800,28000,4,Y,No,21,3,4,80,0,21,4,3,18,11,10,17
30,No,Travel_Rarely,720,Sales,8,2,Technical Degree,1,1128,3,Male,55,2,2,Sales Executive,2,Married,6200,16000,1,Y,No,14,3,2,80,1,8,3,2,7,4,2,6
49,No,Travel_Frequently,1560,Research & Development,25,5,Medical,1,1129,4,Female,92,3,4,Research Director,4,Single,25500,35500,6,Y,Yes,25,4,3,80,1,27,5,4,24,14,19,22
34,Yes,Travel_Rarely,860,Sales,10,3,Marketing,1,1130,2,Male,62,3,2,Sales Executive,3,Divorced,7600,18000,4,Y,No,16,3,2,80,2,11,3,2,8,5,3,7
41,No,Non-Travel,1180,Research & Development,17,4,Life Sciences,1,1131,3,Female,82,4,3,Manufacturing Director,3,Married,16800,26500,5,Y,No,19,3,4,80,0,19,4,3,16,10,9,15
27,No,Travel_Rarely,540,Human Resources,5,2,Human Resources,1,1132,4,Male,45,2,2,Human Resources,2,Single,4400,12000,0,Y,Yes,12,3,3,80,1,5,2,2,4,3,1,3
52,No,Travel_Frequently,1620,Sales,28,4,Technical Degree,1,1133,3,Female,95,4,4,Manager,4,Divorced,22500,33500,8,Y,No,26,4,4,80,1,30,6,4,27,18,20,25
38,Yes,Travel_Rarely,980,Research & Development,14,3,Medical,1,1134,2,Male,75,3,2,Research Scientist,2,Single,9000,20000,3,Y,Yes,19,3,2,80,2,15,3,3,12,8,6,11
45,No,Non-Travel,1320,Human Resources,21,4,Human Resources,1,1135,4,Female,88,3,3,Manager,4,Married,18800,29500,4,Y,No,23,3,4,80,0,23,4,3,20,13,12,19
31,No,Travel_Rarely,760,Sales,9,2,Marketing,1,1136,3,Male,58,2,2,Sales Executive,2,Divorced,6500,16500,1,Y,No,15,3,2,80,1,9,3,2,8,5,3,7
50,No,Travel_Frequently,1580,Research & Development,26,5,Life Sciences,1,1137,4,Female,95,3,4,Research Director,4,Single,26500,36000,6,Y,Yes,26,4,3,80,1,28,5,4,25,15,21,23
36,Yes,Travel_Rarely,920,Sales,12,3,Technical Degree,1,1138,2,Male,68,3,2,Sales Executive,3,Married,8200,19000,4,Y,No,17,3,2,80,2,13,3,2,10,6,4,9
42,No,Non-Travel,1200,Research & Development,18,4,Medical,1,1139,3,Female,82,4,3,Manufacturing Director,3,Single,17000,27000,5,Y,No,20,3,4,80,0,20,4,3,17,11,10,16
26,No,Travel_Rarely,500,Human Resources,4,1,Human Resources,1,1140,4,Male,42,2,2,Human Resources,2,Married,3800,11000,0,Y,Yes,11,3,3,80,1,4,2,2,4,2,1,3
53,No,Travel_Frequently,1660,Sales,29,4,Marketing,1,1141,3,Female,98,4,4,Manager,4,Divorced,24000,36000,8,Y,No,27,4,4,80,1,31,6,4,28,19,21,26
39,Yes,Travel_Rarely,1020,Research & Development,15,3,Life Sciences,1,1142,2,Male,78,3,2,Research Scientist,2,Single,9400,21000,3,Y,Yes,20,3,2,80,2,16,3,3,13,8,6,12
46,No,Non-Travel,1360,Human Resources,22,4,Human Resources,1,1143,4,Female,90,3,3,Manager,4,Married,19500,30500,4,Y,No,24,3,4,80,0,24,4,3,21,13,14,19
33,No,Travel_Rarely,800,Sales,10,2,Technical Degree,1,1144,3,Male,62,2,2,Sales Executive,2,Divorced,7000,17500,1,Y,No,16,3,2,80,1,10,3,2,8,5,3,7
54,No,Travel_Frequently,1680,Research & Development,30,5,Medical,1,1145,4,Female,98,3,4,Research Director,4,Single,27000,37000,6,Y,Yes,28,4,3,80,1,32,6,4,29,16,23,26
40,Yes,Travel_Rarely,1060,Sales,16,3,Marketing,1,1146,2,Male,82,3,2,Sales Executive,3,Married,9800,21500,4,Y,No,21,3,2,80,2,17,3,2,14,9,7,13
47,No,Non-Travel,1380,Research & Development,23,4,Life Sciences,1,1147,3,Female,92,4,3,Manufacturing Director,3,Divorced,19200,29500,5,Y,No,25,3,4,80,0,25,4,3,22,14,15,21
34,No,Travel_Rarely,840,Human Resources,10,2,Human Resources,1,1148,4,Male,65,2,2,Human Resources,2,Single,6200,16000,0,Y,Yes,17,3,3,80,1,11,3,2,9,6,4,8
51,No,Travel_Frequently,1620,Sales,27,4,Technical Degree,1,1149,3,Female,95,4,4,Manager,4,Married,23000,34000,8,Y,No,25,4,4,80,1,29,5,4,26,17,18,24
37,Yes,Travel_Rarely,960,Research & Development,13,3,Medical,1,1150,2,Male,72,3,2,Research Scientist,2,Single,8800,20000,3,Y,Yes,18,3,2,80,2,14,3,3,11,7,5,10
44,No,Non-Travel,1300,Human Resources,20,4,Human Resources,1,1151,4,Female,88,3,3,Manager,4,Divorced,18200,29000,4,Y,No,22,3,4,80,0,22,4,3,19,12,11,18
28,No,Travel_Rarely,640,Sales,6,2,Marketing,1,1152,3,Male,52,2,2,Sales Executive,2,Married,5400,14500,1,Y,No,13,3,2,80,1,6,2,3,5,3,1,4
48,No,Travel_Frequently,1540,Research & Development,24,5,Life Sciences,1,1153,4,Female,92,3,4,Research Director,4,Single,25500,35500,6,Y,Yes,24,4,3,80,1,26,5,4,23,13,17,21
35,Yes,Travel_Rarely,900,Sales,11,3,Technical Degree,1,1154,2,Male,68,3,2,Sales Executive,3,Divorced,8000,18500,4,Y,No,16,3,2,80,2,12,3,2,9,6,4,8
43,No,Non-Travel,1280,Research & Development,19,4,Medical,1,1155,3,Female,85,4,3,Manufacturing Director,3,Married,17800,28000,5,Y,No,21,3,4,80,0,21,4,3,18,11,10,17
29,No,Travel_Rarely,680,Human Resources,7,2,Human Resources,1,1156,4,Male,55,2,2,Human Resources,2,Single,5800,15500,0,Y,Yes,14,3,3,80,1,7,3,2,6,4,2,5
49,No,Travel_Frequently,1580,Sales,25,4,Marketing,1,1157,3,Female,95,4,4,Manager,4,Divorced,22000,33000,7,Y,No,25,4,4,80,1,27,5,4,24,15,19,22
32,Yes,Travel_Rarely,820,Research & Development,9,3,Life Sciences,1,1158,2,Male,60,3,2,Research Scientist,3,Single,7400,17500,3,Y,Yes,15,3,2,80,2,9,3,3,7,4,2,6
41,No,Non-Travel,1220,Human Resources,17,4,Human Resources,1,1159,4,Female,82,3,3,Manager,4,Married,16500,26500,4,Y,No,19,3,4,80,0,19,4,3,16,10,9,15
26,No,Travel_Rarely,520,Sales,4,1,Technical Degree,1,1160,3,Male,45,2,2,Sales Executive,2,Divorced,4400,13000,0,Y,No,11,3,2,80,1,4,2,3,3,2,0,2
55,No,Travel_Frequently,1700,Research & Development,31,5,Medical,1,1161,4,Female,98,3,4,Research Director,4,Single,28000,38000,6,Y,Yes,29,4,3,80,1,33,6,4,30,17,24,27
38,Yes,Travel_Rarely,1000,Sales,14,3,Marketing,1,1162,2,Male,75,3,2,Sales Executive,2,Married,9200,20500,4,Y,No,19,3,2,80,2,15,3,2,12,8,6,11
45,No,Non-Travel,1340,Research & Development,21,4,Life Sciences,1,1163,3,Female,88,4,3,Manufacturing Director,3,Divorced,19000,29500,5,Y,No,23,3,4,80,0,23,4,3,20,13,12,19
33,No,Travel_Rarely,840,Human Resources,10,2,Human Resources,1,1164,4,Male,62,2,2,Human Resources,2,Single,6800,17000,0,Y,Yes,16,3,3,80,1,10,3,2,8,5,3,7
52,No,Travel_Frequently,1660,Sales,28,4,Technical Degree,1,1165,3,Female,95,4,4,Manager,4,Married,24000,35000,8,Y,No,26,4,4,80,1,30,5,4,27,18,20,25
39,Yes,Travel_Rarely,1040,Research & Development,15,3,Medical,1,1166,2,Male,78,3,2,Research Scientist,2,Single,9600,21000,3,Y,Yes,20,3,2,80,2,16,3,3,13,8,6,12
46,No,Non-Travel,1380,Human Resources,22,4,Human Resources,1,1167,4,Female,90,3,3,Manager,4,Divorced,19800,31000,4,Y,No,24,3,4,80,0,24,4,3,21,13,14,19
30,No,Travel_Rarely,740,Sales,8,2,Marketing,1,1168,3,Male,58,2,2,Sales Executive,2,Married,6400,16500,1,Y,No,14,3,2,80,1,8,3,2,7,4,2,6
50,No,Travel_Frequently,1600,Research & Development,26,5,Life Sciences,1,1169,4,Female,95,3,4,Research Director,4,Single,26500,37000,6,Y,Yes,26,4,3,80,1,28,5,4,25,15,21,23
36,Yes,Travel_Rarely,940,Sales,12,3,Technical Degree,1,1170,2,Male,70,3,2,Sales Executive,3,Divorced,8400,19500,4,Y,No,17,3,2,80,2,13,3,2,10,6,4,9
43,No,Non-Travel,1300,Research & Development,19,4,Medical,1,1171,3,Female,85,4,3,Manufacturing Director,3,Married,18200,28500,5,Y,No,21,3,4,80,0,21,4,3,18,11,10,17
27,No,Travel_Rarely,560,Human Resources,5,1,Human Resources,1,1172,4,Male,48,2,2,Human Resources,2,Single,4600,12500,0,Y,Yes,12,3,3,80,1,5,2,2,4,3,1,3
53,No,Travel_Frequently,1680,Sales,29,4,Marketing,1,1173,3,Female,98,4,4,Manager,4,Divorced,24500,36500,8,Y,No,27,4,4,80,1,31,6,4,28,19,21,26
40,Yes,Travel_Rarely,1080,Research & Development,16,3,Life Sciences,1,1174,2,Male,82,3,2,Research Scientist,2,Single,10000,22000,3,Y,Yes,21,3,2,80,2,17,3,3,14,9,7,13
47,No,Non-Travel,1420,Human Resources,23,4,Human Resources,1,1175,4,Female,92,3,3,Manager,4,Married,20500,32000,4,Y,No,25,3,4,80,0,25,4,3,22,14,15,21
34,No,Travel_Rarely,860,Sales,10,2,Technical Degree,1,1176,3,Male,65,2,2,Sales Executive,2,Divorced,7600,18000,1,Y,No,17,3,2,80,1,11,3,2,9,6,4,8
54,No,Travel_Frequently,1720,Research & Development,30,5,Medical,1,1177,4,Female,98,3,4,Research Director,4,Single,28500,39000,6,Y,Yes,28,4,3,80,1,32,6,4,29,16,23,26
41,Yes,Travel_Rarely,1100,Sales,17,3,Marketing,1,1178,2,Male,85,3,2,Sales Executive,3,Married,10200,23000,4,Y,No,22,3,2,80,2,18,3,2,15,10,8,14
48,No,Non-Travel,1460,Research & Development,24,4,Life Sciences,1,1179,3,Female,95,4,3,Manufacturing Director,3,Divorced,20000,30500,5,Y,No,26,3,4,80,0,26,4,3,23,15,16,22
31,No,Travel_Rarely,780,Human Resources,9,2,Human Resources,1,1180,4,Male,60,2,2,Human Resources,2,Single,6800,17500,0,Y,Yes,15,3,3,80,1,9,3,2,8,5,3,7
51,No,Travel_Frequently,1640,Sales,27,4,Technical Degree,1,1181,3,Female,95,4,4,Manager,4,Married,24000,35500,8,Y,No,25,4,4,80,1,29,5,4,26,17,18,24
37,Yes,Travel_Rarely,980,Research & Development,13,3,Medical,1,1182,2,Male,75,3,2,Research Scientist,2,Single,9000,21000,3,Y,Yes,18,3,2,80,2,14,3,3,11,7,5,10
44,No,Non-Travel,1320,Human Resources,20,4,Human Resources,1,1183,4,Female,88,3,3,Manager,4,Divorced,18800,30000,4,Y,No,22,3,4,80,0,22,4,3,19,12,11,18
28,No,Travel_Rarely,660,Sales,6,2,Marketing,1,1184,3,Male,52,2,2,Sales Executive,2,Married,5600,15000,1,Y,No,13,3,2,80,1,6,2,3,5,3,1,4
49,No,Travel_Frequently,1600,Research & Development,25,5,Life Sciences,1,1185,4,Female,95,3,4,Research Director,4,Single,27000,37500,6,Y,Yes,25,4,3,80,1,27,5,4,24,14,19,22
35,Yes,Travel_Rarely,920,Sales,11,3,Technical Degree,1,1186,2,Male,68,3,2,Sales Executive,3,Divorced,8200,19000,4,Y,No,16,3,2,80,2,12,3,2,9,6,4,8
42,No,Non-Travel,1300,Research & Development,18,4,Medical,1,1187,3,Female,82,4,3,Manufacturing Director,3,Married,18000,28500,5,Y,No,20,3,4,80,0,20,4,3,17,11,10,16
29,No,Travel_Rarely,700,Human Resources,7,2,Human Resources,1,1188,4,Male,55,2,2,Human Resources,2,Single,6000,15500,0,Y,Yes,14,3,3,80,1,7,3,2,6,4,2,5
50,No,Travel_Frequently,1620,Sales,26,4,Marketing,1,1189,3,Female,95,4,4,Manager,4,Divorced,23000,34500,7,Y,No,26,4,4,80,1,28,5,4,25,16,20,23
38,Yes,Travel_Rarely,1020,Research & Development,14,3,Life Sciences,1,1190,2,Male,78,3,2,Research Scientist,2,Single,9400,21500,3,Y,Yes,19,3,2,80,2,15,3,3,12,8,6,11
45,No,Non-Travel,1380,Human Resources,21,4,Human Resources,1,1191,4,Female,90,3,3,Manager,4,Married,19200,30500,4,Y,No,23,3,4,80,0,23,4,3,20,13,12,19
32,No,Travel_Rarely,820,Sales,9,2,Technical Degree,1,1192,3,Male,62,2,2,Sales Executive,2,Divorced,7200,17500,1,Y,No,15,3,2,80,1,9,3,2,8,5,3,7
55,No,Travel_Frequently,1740,Research & Development,31,5,Medical,1,1193,4,Female,98,3,4,Research Director,4,Single,29000,39500,6,Y,Yes,29,4,3,80,1,33,6,4,30,17,24,27
39,Yes,Travel_Rarely,1060,Sales,15,3,Marketing,1,1194,2,Male,82,3,2,Sales Executive,3,Married,9800,22000,4,Y,No,20,3,2,80,2,16,3,2,13,8,6,12
46,No,Non-Travel,1420,Research & Development,22,4,Life Sciences,1,1195,3,Female,92,4,3,Manufacturing Director,3,Divorced,19800,31000,5,Y,No,24,3,4,80,0,24,4,3,21,13,14,19
33,No,Travel_Rarely,860,Human Resources,10,2,Human Resources,1,1196,4,Male,65,2,2,Human Resources,2,Single,7400,18000,0,Y,Yes,16,3,3,80,1,10,3,2,8,5,3,7
52,No,Travel_Frequently,1680,Sales,28,4,Technical Degree,1,1197,3,Female,95,4,4,Manager,4,Married,24500,36000,8,Y,No,26,4,4,80,1,30,5,4,27,18,20,25
40,Yes,Travel_Rarely,1100,Research & Development,16,3,Medical,1,1198,2,Male,85,3,2,Research Scientist,2,Single,10200,23000,3,Y,Yes,21,3,2,80,2,17,3,3,14,9,7,13
47,No,Non-Travel,1440,Human Resources,23,4,Human Resources,1,1199,4,Female,92,3,3,Manager,4,Divorced,20800,32500,4,Y,No,25,3,4,80,0,25,4,3,22,14,15,21
34,No,Travel_Rarely,880,Sales,10,2,Marketing,1,1200,3,Male,68,2,2,Sales Executive,2,Married,7800,18500,1,Y,No,17,3,2,80,1,11,3,2,9,6,4,8
28,No,Travel_Rarely,1125,Sales,12,3,Business,1,1001,4,Female,45,4,3,Sales Executive,4,Single,8500,18500,2,Y,No,15,4,3,80,1,8,3,3,7,5,2,4
31,Yes,Travel_Frequently,890,Research & Development,5,4,Engineering,1,1002,2,Male,67,3,2,Research Scientist,3,Married,5200,22100,1,Y,Yes,18,3,4,80,2,9,2,2,8,6,1,5
26,No,Non-Travel,1350,Human Resources,3,2,Psychology,1,1003,3,Female,52,2,1,HR Specialist,2,Divorced,4800,15600,0,Y,No,12,3,2,80,0,4,4,4,3,2,0,2
45,No,Travel_Rarely,750,Sales,18,5,Marketing,1,1004,4,Male,78,4,4,Sales Manager,4,Married,12500,28000,3,Y,No,20,4,4,80,2,22,1,3,15,12,8,10
29,Yes,Travel_Frequently,620,Research & Development,8,3,Life Sciences,1,1005,1,Female,41,2,1,Laboratory Technician,1,Single,3200,12400,4,Y,Yes,14,3,1,80,1,6,5,2,4,3,1,3
37,No,Travel_Rarely,980,Sales,15,4,Business,1,1006,3,Male,89,3,3,Sales Executive,3,Divorced,7800,19200,2,Y,No,16,3,3,80,1,14,2,4,12,9,3,7
24,No,Travel_Frequently,1420,Research & Development,2,1,Technical Degree,1,1007,4,Female,33,4,1,Research Scientist,4,Married,2900,8700,0,Y,No,22,4,4,80,0,2,3,3,2,1,0,1
52,No,Travel_Rarely,670,Human Resources,22,3,Human Resources,1,1008,2,Male,95,2,5,HR Manager,2,Married,15200,25800,5,Y,Yes,13,3,2,80,3,28,2,2,20,15,6,12
33,No,Non-Travel,1200,Sales,7,4,Marketing,1,1009,4,Female,58,3,2,Sales Representative,4,Single,4600,16800,1,Y,No,19,3,4,80,1,10,3,3,8,6,2,5
41,Yes,Travel_Rarely,850,Research & Development,11,2,Medical,1,1010,1,Male,72,1,2,Healthcare Representative,1,Married,6500,21300,6,Y,Yes,11,3,1,80,2,17,4,1,14,8,5,9
30,No,Travel_Frequently,1100,Sales,4,3,Life Sciences,1,1011,3,Female,64,4,2,Sales Executive,3,Divorced,5800,17400,3,Y,No,17,4,3,80,1,7,2,3,6,4,1,3
46,No,Travel_Rarely,720,Research & Development,20,4,Engineering,1,1012,4,Male,87,3,4,Research Director,4,Married,13800,32500,4,Y,No,21,4,4,80,2,24,1,4,18,14,10,15
27,Yes,Travel_Frequently,950,Human Resources,6,2,Psychology,1,1013,2,Female,46,2,1,HR Specialist,2,Single,3800,11900,2,Y,Yes,13,3,2,80,1,5,6,2,4,2,0,2
35,No,Travel_Rarely,1380,Sales,13,5,Business,1,1014,3,Male,91,4,3,Sales Manager,3,Married,9200,24600,1,Y,No,18,4,3,80,2,12,3,3,10,7,4,8
22,No,Non-Travel,580,Research & Development,1,1,Life Sciences,1,1015,4,Female,29,3,1,Laboratory Technician,4,Single,2400,6800,0,Y,No,20,3,4,80,0,1,4,3,1,0,0,0
38,No,Travel_Rarely,1250,Sales,16,3,Marketing,1,1016,2,Male,76,2,2,Sales Executive,2,Divorced,6900,20500,5,Y,Yes,15,3,2,80,1,15,2,2,13,10,5,8
25,Yes,Travel_Frequently,690,Research & Development,9,2,Technical Degree,1,1017,1,Female,38,1,1,Research Scientist,1,Married,3100,9600,1,Y,Yes,16,3,1,80,1,3,5,1,3,2,1,2
49,No,Travel_Rarely,1450,Human Resources,25,4,Human Resources,1,1018,4,Male,98,4,5,HR Director,4,Married,18500,38200,6,Y,No,14,4,4,80,3,26,1,4,22,18,12,16
32,No,Travel_Frequently,830,Sales,10,3,Life Sciences,1,1019,3,Female,62,3,2,Sales Representative,3,Single,4900,14700,2,Y,No,19,3,3,80,1,9,3,3,7,5,2,4
43,Yes,Travel_Rarely,1150,Research & Development,14,4,Medical,1,1020,2,Male,84,2,3,Healthcare Representative,2,Divorced,7200,23100,4,Y,Yes,12,3,2,80,2,19,3,2,16,11,7,10
26,No,Non-Travel,770,Sales,3,2,Business,1,1021,4,Female,42,4,1,Sales Executive,4,Married,3600,10200,0,Y,No,23,4,4,80,0,4,4,4,3,2,0,2
54,No,Travel_Rarely,1320,Research & Development,21,5,Engineering,1,1022,3,Male,88,3,4,Research Director,3,Married,16200,35800,7,Y,No,17,4,3,80,2,31,2,3,25,20,15,18
29,No,Travel_Frequently,650,Human Resources,7,3,Psychology,1,1023,1,Female,51,1,2,HR Specialist,1,Single,4200,13500,3,Y,Yes,14,3,1,80,1,6,5,1,5,3,1,3
36,Yes,Travel_Rarely,1180,Sales,12,4,Marketing,1,1024,4,Male,73,4,3,Sales Manager,4,Divorced,8800,22900,2,Y,No,21,4,4,80,2,13,2,4,11,8,4,7
21,No,Travel_Frequently,460,Research & Development,2,1,Life Sciences,1,1025,2,Female,27,2,1,Laboratory Technician,2,Single,2200,5400,0,Y,No,18,3,2,80,0,0,6,2,0,0,0,0
40,No,Travel_Rarely,1090,Sales,17,3,Business,1,1026,3,Male,69,3,2,Sales Executive,3,Married,7500,19800,4,Y,Yes,16,3,3,80,1,16,2,3,14,11,6,9
23,Yes,Non-Travel,580,Research & Development,4,2,Technical Degree,1,1027,1,Female,35,1,1,Research Scientist,1,Divorced,2800,8100,1,Y,Yes,22,3,1,80,1,2,4,1,2,1,0,1
48,No,Travel_Rarely,1280,Human Resources,19,4,Human Resources,1,1028,4,Male,92,4,5,HR Manager,4,Married,14800,31200,5,Y,No,13,4,4,80,3,25,1,4,21,16,11,14
31,No,Travel_Frequently,920,Sales,8,3,Life Sciences,1,1029,2,Female,57,2,2,Sales Representative,2,Single,5100,15900,2,Y,No,20,3,2,80,1,8,3,2,6,4,2,4
44,Yes,Travel_Rarely,1380,Research & Development,23,4,Medical,1,1030,3,Male,81,3,3,Healthcare Representative,3,Married,8200,26400,6,Y,Yes,11,3,3,80,2,21,3,3,18,13,8,12
28,No,Travel_Frequently,710,Sales,6,2,Marketing,1,1031,4,Female,48,4,1,Sales Executive,4,Divorced,4400,12800,1,Y,No,19,4,4,80,1,5,4,4,4,3,1,2
53,No,Travel_Rarely,1420,Research & Development,26,5,Engineering,1,1032,1,Male,96,1,4,Research Director,1,Single,17500,39600,8,Y,Yes,15,3,1,80,2,30,2,1,27,22,16,20
24,No,Non-Travel,640,Human Resources,5,1,Psychology,1,1033,3,Female,40,3,2,HR Specialist,3,Married,3400,9800,0,Y,No,17,3,3,80,0,2,5,3,2,1,0,1
39,No,Travel_Rarely,1180,Research & Development,16,4,Medical,1,1200,3,Male,73,3,3,Healthcare Representative,3,Single,7700,26000,4,Y,No,18,3,3,80,2,16,3,3,13,9,5,8
45,No,Travel_Rarely,1070,Sales,15,4,Business,1,1034,4,Male,75,4,3,Sales Manager,4,Divorced,9600,24800,3,Y,No,18,4,4,80,2,16,2,4,13,10,5,8
22,Yes,Travel_Frequently,520,Research & Development,3,2,Life Sciences,1,1035,2,Female,31,2,1,Laboratory Technician,2,Single,2600,7200,1,Y,Yes,21,3,2,80,1,1,5,2,1,0,0,0
47,No,Travel_Rarely,1350,Sales,22,3,Marketing,1,1036,3,Male,89,3,2,Sales Executive,3,Married,8600,21700,5,Y,No,14,3,3,80,1,24,2,3,21,16,9,13
25,No,Travel_Frequently,780,Research & Development,7,2,Technical Degree,1,1037,4,Female,44,4,1,Research Scientist,4,Single,3500,10500,0,Y,No,23,4,4,80,0,3,4,4,3,2,1,2
51,Yes,Travel_Rarely,1180,Human Resources,28,4,Human Resources,1,1038,1,Male,85,1,5,HR Director,1,Divorced,16800,36400,7,Y,Yes,12,3,1,80,3,28,1,1,25,19,14,17
30,No,Non-Travel,860,Sales,9,3,Life Sciences,1,1039,2,Female,54,2,2,Sales Representative,2,Married,4800,14200,2,Y,No,16,3,2,80,1,7,3,2,5,4,1,3
42,No,Travel_Rarely,1240,Research & Development,18,4,Medical,1,1040,4,Male,78,4,3,Healthcare Representative,4,Single,7800,25200,4,Y,Yes,20,4,4,80,2,19,3,4,16,12,7,11
27,Yes,Travel_Frequently,680,Sales,4,2,Business,1,1041,3,Female,41,3,1,Sales Executive,3,Divorced,4100,11600,1,Y,Yes,18,3,3,80,1,4,5,3,3,2,0,2
56,No,Travel_Rarely,1450,Research & Development,24,5,Engineering,1,1042,2,Male,93,2,4,Research Director,2,Married,18200,41500,9,Y,No,13,3,2,80,2,33,2,2,29,24,18,22
26,No,Travel_Frequently,590,Human Resources,8,1,Psychology,1,1043,4,Female,37,4,2,HR Specialist,4,Single,3200,8600,0,Y,No,22,4,4,80,0,3,6,4,3,2,1,2
35,No,Travel_Rarely,1120,Sales,14,3,Marketing,1,1044,1,Male,67,1,3,Sales Manager,1,Married,8200,20900,2,Y,Yes,15,3,1,80,2,12,2,1,10,7,3,6
23,Yes,Non-Travel,480,Research & Development,2,2,Life Sciences,1,1045,3,Female,28,3,1,Laboratory Technician,3,Divorced,2300,6100,1,Y,No,24,3,3,80,1,1,4,3,1,0,0,0
49,No,Travel_Rarely,1320,Sales,20,4,Business,1,1046,4,Male,82,4,2,Sales Executive,4,Married,9400,23600,6,Y,No,17,4,4,80,1,26,2,4,23,18,11,15
28,No,Travel_Frequently,750,Research & Development,6,3,Technical Degree,1,1047,2,Female,46,2,1,Research Scientist,2,Single,3800,11400,2,Y,Yes,19,3,2,80,1,5,4,2,4,3,1,3
45,Yes,Travel_Rarely,1290,Human Resources,25,4,Human Resources,1,1048,1,Male,88,1,5,HR Manager,1,Divorced,15600,34200,5,Y,Yes,14,3,1,80,3,22,1,1,19,14,8,12
32,No,Travel_Frequently,840,Sales,11,3,Life Sciences,1,1049,3,Female,59,3,2,Sales Representative,3,Married,5200,16400,3,Y,No,18,3,3,80,1,9,3,3,7,5,2,4
38,No,Travel_Rarely,1160,Research & Development,16,4,Medical,1,1050,4,Male,74,4,3,Healthcare Representative,4,Single,7400,24600,4,Y,No,16,4,4,80,2,15,3,4,13,9,5,8
24,Yes,Non-Travel,620,Sales,5,1,Marketing,1,1051,2,Female,34,2,1,Sales Executive,2,Divorced,3400,9200,0,Y,Yes,21,3,2,80,0,2,5,2,2,1,0,1
52,No,Travel_Rarely,1380,Research & Development,27,5,Engineering,1,1052,3,Male,91,3,4,Research Director,3,Married,17800,38900,8,Y,No,13,3,3,80,2,29,2,3,26,21,15,19
29,No,Travel_Frequently,690,Human Resources,7,2,Psychology,1,1053,4,Female,43,4,2,HR Specialist,4,Single,3900,12100,1,Y,No,20,4,4,80,1,6,4,4,5,3,1,3
41,Yes,Travel_Rarely,1200,Sales,19,3,Business,1,1054,1,Male,77,1,3,Sales Manager,1,Married,8800,22400,5,Y,Yes,15,3,1,80,2,18,2,1,15,11,6,9
25,No,Travel_Frequently,560,Research & Development,3,2,Life Sciences,1,1055,2,Female,32,2,1,Laboratory Technician,2,Divorced,2700,7800,2,Y,No,23,3,2,80,1,3,5,2,2,1,0,1
46,No,Travel_Rarely,1350,Sales,21,4,Marketing,1,1056,4,Male,86,4,2,Sales Executive,4,Single,9100,24100,7,Y,No,17,4,4,80,1,23,2,4,20,15,9,13
27,Yes,Non-Travel,720,Research & Development,8,3,Technical Degree,1,1057,3,Female,39,3,1,Research Scientist,3,Married,3600,10800,1,Y,Yes,19,3,3,80,1,4,4,3,3,2,1,2
50,No,Travel_Rarely,1410,Human Resources,26,4,Human Resources,1,1058,2,Male,94,2,5,HR Director,2,Divorced,17200,37800,6,Y,No,12,3,2,80,3,27,1,2,24,18,13,16
33,No,Travel_Frequently,880,Sales,10,3,Life Sciences,1,1059,4,Female,56,4,2,Sales Representative,4,Married,5400,17200,2,Y,No,18,4,4,80,1,10,3,4,8,6,2,5
37,Yes,Travel_Rarely,1140,Research & Development,15,4,Medical,1,1060,1,Male,72,1,3,Healthcare Representative,1,Single,7600,25800,3,Y,Yes,16,3,1,80,2,14,3,1,12,8,4,7
26,No,Travel_Frequently,640,Sales,4,2,Business,1,1061,3,Female,38,3,1,Sales Executive,3,Divorced,3800,10800,1,Y,No,22,3,3,80,1,3,5,3,2,1,0,1
54,No,Travel_Rarely,1420,Research & Development,28,5,Engineering,1,1062,4,Male,89,4,4,Research Director,4,Married,18600,42200,9,Y,No,14,4,4,80,2,31,2,4,28,23,17,21
28,Yes,Non-Travel,760,Human Resources,6,1,Psychology,1,1063,2,Female,45,2,2,HR Specialist,2,Single,3500,10100,0,Y,Yes,20,3,2,80,0,5,6,2,4,3,1,3
44,No,Travel_Rarely,1280,Sales,22,3,Marketing,1,1064,3,Male,81,3,3,Sales Manager,3,Married,9800,25600,4,Y,No,15,3,3,80,2,21,2,3,18,14,8,12
31,No,Travel_Frequently,820,Research & Development,9,3,Life Sciences,1,1065,4,Female,53,4,1,Laboratory Technician,4,Divorced,4200,13800,3,Y,No,19,4,4,80,1,8,3,4,6,4,2,4
48,Yes,Travel_Rarely,1360,Sales,24,4,Business,1,1066,1,Male,85,1,2,Sales Executive,1,Single,8400,21800,6,Y,Yes,13,3,1,80,1,25,2,1,22,17,10,14
24,No,Travel_Frequently,580,Research & Development,5,2,Technical Degree,1,1067,2,Female,35,2,1,Research Scientist,2,Married,2900,8500,0,Y,No,24,3,2,80,1,2,5,2,2,1,0,1
53,No,Travel_Rarely,1450,Human Resources,29,4,Human Resources,1,1068,4,Male,97,4,5,HR Director,4,Divorced,19200,41800,8,Y,No,11,4,4,80,3,30,1,4,27,22,16,20
30,No,Non-Travel,900,Sales,8,3,Life Sciences,1,1069,3,Female,58,3,2,Sales Representative,3,Single,5000,15600,2,Y,No,17,3,3,80,1,7,4,3,5,4,1,3
42,Yes,Travel_Rarely,1220,Research & Development,17,4,Medical,1,1070,2,Male,76,2,3,Healthcare Representative,2,Married,7800,26200,5,Y,Yes,18,3,2,80,2,19,3,2,16,12,7,11
27,No,Travel_Frequently,660,Sales,3,2,Marketing,1,1071,4,Female,40,4,1,Sales Executive,4,Divorced,3900,11200,1,Y,No,21,4,4,80,1,4,4,4,3,2,1,2
47,No,Travel_Rarely,1340,Research & Development,23,5,Engineering,1,1072,1,Male,90,1,4,Research Director,1,Single,17400,39200,7,Y,Yes,16,3,1,80,2,24,2,1,21,16,12,16
25,Yes,Travel_Frequently,720,Human Resources,7,1,Psychology,1,1073,3,Female,42,3,2,HR Specialist,3,Married,3300,9400,0,Y,Yes,22,3,3,80,0,3,6,3,2,1,0,1
36,No,Travel_Rarely,1100,Sales,13,3,Business,1,1074,4,Male,68,4,3,Sales Manager,4,Divorced,8600,22200,3,Y,No,19,4,4,80,2,13,2,4,11,8,4,7
29,No,Non-Travel,840,Research & Development,10,3,Life Sciences,1,1075,2,Female,51,2,1,Laboratory Technician,2,Single,4000,12600,2,Y,No,18,3,2,80,1,6,4,2,5,3,1,3
43,Yes,Travel_Rarely,1260,Sales,20,4,Marketing,1,1076,3,Male,79,3,2,Sales Executive,3,Married,9200,24400,4,Y,Yes,14,3,3,80,1,20,2,3,17,13,8,11
26,No,Travel_Frequently,600,Research & Development,4,2,Technical Degree,1,1077,4,Female,36,4,1,Research Scientist,4,Divorced,3200,9600,1,Y,No,23,4,4,80,1,3,5,4,2,1,0,1
51,No,Travel_Rarely,1420,Human Resources,27,4,Human Resources,1,1078,1,Male,93,1,5,HR Manager,1,Single,18400,40600,9,Y,Yes,12,3,1,80,3,28,1,1,25,19,14,17
32,Yes,Travel_Frequently,860,Sales,11,3,Life Sciences,1,1079,2,Female,55,2,2,Sales Representative,2,Married,5100,16200,3,Y,No,20,3,2,80,1,9,3,2,7,5,2,4
39,No,Travel_Rarely,1180,Research & Development,16,4,Medical,1,1080,4,Male,73,4,3,Healthcare Representative,4,Divorced,7600,25400,4,Y,No,17,4,4,80,2,16,3,4,14,10,5,8
23,No,Non-Travel,540,Sales,2,1,Business,1,1081,3,Female,31,3,1,Sales Executive,3,Single,2800,7600,0,Y,No,25,3,3,80,0,1,6,3,1,0,0,0
49,Yes,Travel_Rarely,1380,Research & Development,25,5,Engineering,1,1082,2,Male,87,2,4,Research Director,2,Married,17800,39800,8,Y,Yes,15,3,2,80,2,26,2,2,23,18,13,17
28,No,Travel_Frequently,740,Human Resources,8,2,Psychology,1,1083,4,Female,44,4,2,HR Specialist,4,Single,3700,11000,1,Y,No,19,4,4,80,1,5,5,4,4,3,1,3
45,No,Travel_Rarely,1300,Sales,21,3,Marketing,1,1084,1,Male,83,1,3,Sales Manager,1,Divorced,9400,24800,6,Y,Yes,16,3,1,80,2,22,2,1,19,15,9,13
30,Yes,Travel_Frequently,800,Research & Development,9,3,Life Sciences,1,1085,3,Female,49,3,1,Laboratory Technician,3,Married,3900,12200,2,Y,Yes,18,3,3,80,1,7,4,3,5,4,1,3
52,No,Travel_Rarely,1440,Sales,26,4,Business,1,1086,4,Male,91,4,2,Sales Executive,4,Single,10600,27200,7,Y,No,13,4,4,80,1,29,2,4,26,21,15,19
24,No,Non-Travel,620,Research & Development,5,2,Technical Degree,1,1087,2,Female,37,2,1,Research Scientist,2,Divorced,3000,8800,0,Y,No,24,3,2,80,1,2,6,2,1,0,0,0
46,Yes,Travel_Rarely,1320,Human Resources,23,4,Human Resources,1,1088,3,Male,86,3,5,HR Director,3,Married,16800,37400,5,Y,Yes,14,3,3,80,3,23,1,3,20,15,11,15
31,No,Travel_Frequently,880,Sales,10,3,Life Sciences,1,1089,4,Female,57,4,2,Sales Representative,4,Single,5200,16800,3,Y,No,21,4,4,80,1,8,3,4,6,4,2,4
38,No,Travel_Rarely,1160,Research & Development,15,4,Medical,1,1090,1,Male,75,1,3,Healthcare Representative,1,Married,7900,26800,4,Y,Yes,17,3,1,80,2,15,3,1,13,9,5,8
26,Yes,Travel_Frequently,680,Sales,6,2,Marketing,1,1091,2,Female,41,2,1,Sales Executive,2,Divorced,4000,11400,1,Y,Yes,22,3,2,80,1,3,5,2,2,1,0,1
55,No,Travel_Rarely,1460,Research & Development,28,5,Engineering,1,1092,4,Male,95,4,4,Research Director,4,Single,19400,43600,9,Y,No,12,4,4,80,2,32,2,4,29,24,18,22
27,No,Non-Travel,760,Human Resources,7,1,Psychology,1,1093,3,Female,43,3,2,HR Specialist,3,Married,3400,9600,0,Y,No,20,3,3,80,0,4,6,3,3,2,1,2
40,Yes,Travel_Rarely,1240,Sales,18,3,Business,1,1094,2,Male,79,2,3,Sales Manager,2,Divorced,9000,23800,5,Y,Yes,18,3,2,80,2,17,2,2,15,11,6,10
33,No,Travel_Frequently,820,Research & Development,12,3,Life Sciences,1,1095,4,Female,54,4,1,Laboratory Technician,4,Single,4300,14200,3,Y,No,19,4,4,80,1,10,3,4,8,6,2,5
47,No,Travel_Rarely,1360,Sales,22,4,Marketing,1,1096,1,Male,88,1,2,Sales Executive,1,Married,8800,22600,6,Y,Yes,15,3,1,80,1,24,2,1,21,16,10,14
25,Yes,Travel_Frequently,640,Research & Development,4,2,Technical Degree,1,1097,3,Female,38,3,1,Research Scientist,3,Divorced,3100,9000,1,Y,Yes,23,3,3,80,1,2,5,3,1,0,0,0
50,No,Travel_Rarely,1400,Human Resources,25,4,Human Resources,1,1098,4,Male,92,4,5,HR Manager,4,Single,17600,38800,8,Y,No,16,4,4,80,3,27,1,4,24,18,13,17
29,No,Non-Travel,780,Sales,8,3,Life Sciences,1,1099,2,Female,47,2,2,Sales Representative,2,Married,4700,14800,2,Y,No,17,3,2,80,1,6,4,2,4,3,1,3
44,Yes,Travel_Rarely,1280,Research & Development,19,4,Medical,1,1100,3,Male,82,3,3,Healthcare Representative,3,Single,8200,27400,5,Y,Yes,14,3,3,80,2,21,3,3,18,14,8,12
28,No,Travel_Frequently,700,Sales,5,2,Business,1,1101,4,Female,42,4,1,Sales Executive,4,Divorced,3600,10200,0,Y,No,21,4,4,80,1,5,5,4,4,3,1,3
53,No,Travel_Rarely,1420,Research & Development,27,5,Engineering,1,1102,1,Male,96,1,4,Research Director,1,Married,18800,41200,9,Y,Yes,13,3,1,80,2,30,2,1,27,22,16,20
26,Yes,Travel_Frequently,660,Human Resources,6,1,Psychology,1,1103,2,Female,39,2,2,HR Specialist,2,Single,3200,8400,0,Y,Yes,24,3,2,80,0,3,6,2,2,1,0,1
41,No,Travel_Rarely,1200,Sales,17,3,Marketing,1,1104,4,Male,77,4,3,Sales Manager,4,Divorced,9600,24200,4,Y,No,18,4,4,80,2,18,2,4,15,12,7,11
34,No,Non-Travel,840,Research & Development,11,3,Life Sciences,1,1105,3,Female,52,3,1,Laboratory Technician,3,Married,4100,13400,3,Y,No,16,3,3,80,1,11,3,3,9,7,3,6
48,Yes,Travel_Rarely,1340,Sales,23,4,Business,1,1106,2,Male,85,2,2,Sales Executive,2,Single,9800,25800,7,Y,Yes,17,3,2,80,1,25,2,2,22,17,11,15
27,No,Travel_Frequently,720,Research & Development,7,2,Technical Degree,1,1107,4,Female,44,4,1,Research Scientist,4,Married,3400,10600,1,Y,No,22,4,4,80,1,4,5,4,3,2,1,2
51,No,Travel_Rarely,1460,Human Resources,26,4,Human Resources,1,1108,1,Male,94,1,5,HR Director,1,Divorced,19600,43200,8,Y,Yes,15,3,1,80,3,28,1,1,25,19,14,18
32,Yes,Travel_Frequently,880,Sales,9,3,Life Sciences,1,1109,3,Female,56,3,2,Sales Representative,3,Single,5300,17400,2,Y,No,19,3,3,80,1,9,3,3,7,5,2,4
37,No,Travel_Rarely,1140,Research & Development,14,4,Medical,1,1110,4,Male,71,4,3,Healthcare Representative,4,Married,7700,25600,3,Y,No,20,4,4,80,2,14,3,4,12,8,4,7
24,No,Non-Travel,580,Sales,3,1,Marketing,1,1111,2,Female,33,2,1,Sales Executive,2,Divorced,3000,8200,0,Y,Yes,25,3,2,80,0,2,6,2,1,0,0,0
46,Yes,Travel_Rarely,1300,Research & Development,21,5,Engineering,1,1112,1,Male,89,1,4,Research Director,1,Single,17200,38600,6,Y,Yes,16,3,1,80,2,23,2,1,20,15,10,14
30,No,Travel_Frequently,800,Human Resources,8,2,Psychology,1,1113,3,Female,48,3,2,HR Specialist,3,Married,3800,11800,1,Y,No,18,3,3,80,1,7,4,3,5,4,1,3
43,No,Travel_Rarely,1260,Sales,20,3,Business,1,1114,4,Male,80,4,3,Sales Manager,4,Divorced,9400,24600,5,Y,No,14,4,4,80,2,20,2,4,17,13,8,11
31,Yes,Travel_Frequently,820,Research & Development,10,3,Life Sciences,1,1115,2,Female,53,2,1,Laboratory Technician,2,Single,4200,13600,3,Y,Yes,21,3,2,80,1,8,4,2,6,4,2,4
49,No,Travel_Rarely,1380,Sales,24,4,Marketing,1,1116,3,Male,86,3,2,Sales Executive,3,Married,8600,22400,6,Y,No,13,3,3,80,1,26,2,3,23,18,12,16
25,No,Non-Travel,640,Research & Development,4,2,Technical Degree,1,1117,4,Female,37,4,1,Research Scientist,4,Single,2800,7800,0,Y,No,24,4,4,80,1,2,6,4,1,0,0,0
52,Yes,Travel_Rarely,1440,Human Resources,28,4,Human Resources,1,1118,1,Male,95,1,5,HR Manager,1,Divorced,18200,40800,9,Y,Yes,12,3,1,80,3,29,1,1,26,20,15,18
28,No,Travel_Frequently,760,Sales,6,3,Life Sciences,1,1119,2,Female,45,2,2,Sales Representative,2,Married,4500,14000,1,Y,No,19,3,2,80,1,5,5,2,4,3,1,3
45,No,Travel_Rarely,1320,Research & Development,22,4,Medical,1,1120,4,Male,83,4,3,Healthcare Representative,4,Single,8400,28200,5,Y,No,17,4,4,80,2,22,3,4,19,15,9,13
29,Yes,Travel_Frequently,780,Sales,7,2,Business,1,1121,3,Female,46,3,1,Sales Executive,3,Divorced,4200,12400,2,Y,Yes,20,3,3,80,1,6,4,3,5,3,2,4
54,No,Travel_Rarely,1460,Research & Development,29,5,Engineering,1,1122,2,Male,97,2,4,Research Director,2,Married,19800,44200,8,Y,No,15,3,2,80,2,31,2,2,28,23,17,21
26,No,Non-Travel,680,Human Resources,5,1,Psychology,1,1123,4,Female,40,4,2,HR Specialist,4,Single,3100,8800,0,Y,No,23,4,4,80,0,3,6,4,2,1,0,1
38,Yes,Travel_Rarely,1180,Sales,16,3,Marketing,1,1124,1,Male,74,1,3,Sales Manager,1,Married,8800,23200,4,Y,Yes,18,3,1,80,2,15,2,1,13,9,5,8
33,No,Travel_Frequently,860,Research & Development,12,3,Life Sciences,1,1125,3,Female,55,3,1,Laboratory Technician,3,Divorced,4400,14800,3,Y,No,16,3,3,80,1,10,3,3,8,6,2,5
47,No,Travel_Rarely,1340,Sales,23,4,Business,1,1126,4,Male,87,4,2,Sales Executive,4,Single,9000,23800,7,Y,No,19,4,4,80,1,24,2,4,21,16,10,14
24,Yes,Travel_Frequently,600,Research & Development,3,2,Technical Degree,1,1127,2,Female,35,2,1,Research Scientist,2,Married,3300,9800,1,Y,Yes,22,3,2,80,1,1,5,2,1,0,0,0
50,No,Travel_Rarely,1400,Human Resources,25,4,Human Resources,1,1128,3,Male,91,3,5,HR Director,3,Divorced,17800,39400,6,Y,No,14,3,3,80,3,27,1,3,24,18,13,17
35,No,Non-Travel,900,Sales,13,3,Life Sciences,1,1129,4,Female,58,4,2,Sales Representative,4,Single,5400,17600,2,Y,No,17,4,4,80,1,12,3,4,9,7,3,6
42,Yes,Travel_Rarely,1240,Research & Development,18,4,Medical,1,1130,1,Male,78,1,3,Healthcare Representative,1,Married,8000,27000,4,Y,Yes,20,3,1,80,2,19,3,1,16,12,7,11
27,No,Travel_Frequently,720,Sales,5,2,Marketing,1,1131,2,Female,43,2,1,Sales Executive,2,Divorced,3800,11000,1,Y,No,21,3,2,80,1,4,5,2,3,2,1,2
48,No,Travel_Rarely,1360,Research & Development,24,5,Engineering,1,1132,4,Male,90,4,4,Research Director,4,Single,18600,41800,8,Y,No,16,4,4,80,2,25,2,4,22,17,12,16
30,Yes,Travel_Frequently,820,Human Resources,8,2,Psychology,1,1133,3,Female,49,3,2,HR Specialist,3,Married,3600,10400,1,Y,Yes,18,3,3,80,1,7,4,3,5,4,1,3
44,No,Travel_Rarely,1280,Sales,21,3,Business,1,1134,2,Male,81,2,3,Sales Manager,2,Divorced,9200,24400,5,Y,No,15,3,2,80,2,21,2,2,18,14,8,12
31,No,Non-Travel,840,Research & Development,9,3,Life Sciences,1,1135,4,Female,54,4,1,Laboratory Technician,4,Single,4300,14400,3,Y,No,19,4,4,80,1,8,4,4,6,4,2,4
46,Yes,Travel_Rarely,1320,Sales,22,4,Marketing,1,1136,1,Male,84,1,2,Sales Executive,1,Married,8400,21800,6,Y,Yes,17,3,1,80,1,23,2,1,20,15,9,13
23,No,Travel_Frequently,580,Research & Development,2,2,Technical Degree,1,1137,3,Female,32,3,1,Research Scientist,3,Divorced,2600,7400,0,Y,No,25,3,3,80,1,1,6,3,0,0,0,0
51,No,Travel_Rarely,1420,Human Resources,26,4,Human Resources,1,1138,4,Male,93,4,5,HR Manager,4,Single,18800,42400,9,Y,No,13,4,4,80,3,28,1,4,25,19,14,18
28,Yes,Travel_Frequently,740,Sales,6,3,Life Sciences,1,1139,2,Female,44,2,2,Sales Representative,2,Married,4400,13200,1,Y,Yes,20,3,2,80,1,5,5,2,4,3,1,3
39,No,Travel_Rarely,1160,Research & Development,15,4,Medical,1,1140,3,Male,72,3,3,Healthcare Representative,3,Single,7300,24800,3,Y,No,18,3,3,80,2,16,3,3,13,9,5,8
26,No,Non-Travel,660,Sales,4,1,Business,1,1141,4,Female,38,4,1,Sales Executive,4,Divorced,3200,8600,0,Y,No,24,4,4,80,0,3,6,4,2,1,0,1
53,Yes,Travel_Rarely,1440,Research & Development,27,5,Engineering,1,1142,1,Male,96,1,4,Research Director,1,Married,19200,43800,8,Y,Yes,14,3,1,80,2,30,2,1,27,22,16,20
32,No,Travel_Frequently,860,Human Resources,10,2,Psychology,1,1143,2,Female,52,2,2,HR Specialist,2,Single,3900,12600,2,Y,No,21,3,2,80,1,9,4,2,7,5,2,4
45,No,Travel_Rarely,1300,Sales,20,3,Marketing,1,1144,4,Male,82,4,3,Sales Manager,4,Divorced,9600,25200,6,Y,No,16,4,4,80,2,22,2,4,19,15,9,13
29,Yes,Travel_Frequently,780,Research & Development,7,3,Life Sciences,1,1145,3,Female,47,3,1,Laboratory Technician,3,Married,4000,12800,2,Y,Yes,17,3,3,80,1,6,4,3,4,3,1,3
52,No,Travel_Rarely,1420,Sales,25,4,Business,1,1146,2,Male,89,2,2,Sales Executive,2,Single,10200,26800,7,Y,No,15,3,2,80,1,29,2,2,26,21,15,19
25,No,Non-Travel,640,Research & Development,3,2,Technical Degree,1,1147,4,Female,36,4,1,Research Scientist,4,Divorced,2700,7600,0,Y,No,23,4,4,80,1,2,6,4,1,0,0,0
49,Yes,Travel_Rarely,1380,Human Resources,24,4,Human Resources,1,1148,1,Male,88,1,5,HR Director,1,Married,16800,37600,5,Y,Yes,18,3,1,80,3,26,1,1,23,17,12,16
34,No,Travel_Frequently,880,Sales,11,3,Life Sciences,1,1149,3,Female,56,3,2,Sales Representative,3,Single,5200,16600,3,Y,No,19,3,3,80,1,11,3,3,8,6,2,5
40,No,Travel_Rarely,1200,Research & Development,17,4,Medical,1,1150,4,Male,75,4,3,Healthcare Representative,4,Married,7800,26400,4,Y,No,20,4,4,80,2,17,3,4,14,10,5,8
27,Yes,Travel_Frequently,700,Sales,5,2,Marketing,1,1151,2,Female,42,2,1,Sales Executive,2,Divorced,3600,10400,1,Y,Yes,22,3,2,80,1,4,5,2,3,2,1,2
55,No,Travel_Rarely,1460,Research & Development,28,5,Engineering,1,1152,3,Male,94,3,4,Research Director,3,Single,19600,44600,9,Y,No,12,3,3,80,2,32,2,3,29,24,18,22
28,No,Non-Travel,760,Human Resources,6,1,Psychology,1,1153,4,Female,45,4,2,HR Specialist,4,Married,3300,9200,0,Y,No,24,4,4,80,0,5,6,4,4,3,1,3
41,Yes,Travel_Rarely,1220,Sales,18,3,Business,1,1154,1,Male,79,1,3,Sales Manager,1,Divorced,8600,22600,5,Y,Yes,17,3,1,80,2,18,2,1,15,11,6,10
36,No,Travel_Frequently,920,Research & Development,13,3,Life Sciences,1,1155,2,Female,59,2,1,Laboratory Technician,2,Single,4500,15000,3,Y,No,18,3,2,80,1,13,3,2,10,8,4,7
43,No,Travel_Rarely,1260,Sales,19,4,Marketing,1,1156,4,Male,83,4,2,Sales Executive,4,Married,8800,23400,6,Y,No,19,4,4,80,1,20,2,4,17,13,8,11
24,Yes,Travel_Frequently,600,Research & Development,2,2,Technical Degree,1,1157,3,Female,34,3,1,Research Scientist,3,Divorced,2900,8400,0,Y,Yes,21,3,3,80,1,1,5,3,0,0,0,0
50,No,Travel_Rarely,1400,Human Resources,25,4,Human Resources,1,1158,2,Male,92,2,5,HR Manager,2,Single,17400,38200,8,Y,No,16,3,2,80,3,27,1,2,24,18,13,17
33,No,Non-Travel,860,Sales,10,3,Life Sciences,1,1159,4,Female,55,4,2,Sales Representative,4,Married,5100,16400,2,Y,No,20,4,4,80,1,10,3,4,7,5,2,4
37,Yes,Travel_Rarely,1140,Research & Development,14,4,Medical,1,1160,1,Male,73,1,3,Healthcare Representative,1,Single,7500,25200,3,Y,Yes,15,3,1,80,2,14,3,1,12,8,4,7
26,No,Travel_Frequently,680,Sales,4,2,Business,1,1161,3,Female,41,3,1,Sales Executive,3,Divorced,3400,9800,1,Y,No,25,3,3,80,1,3,5,3,2,1,0,1
54,No,Travel_Rarely,1440,Research & Development,27,5,Engineering,1,1162,4,Male,95,4,4,Research Director,4,Married,18800,42800,9,Y,No,13,4,4,80,2,31,2,4,28,23,17,21
30,Yes,Travel_Frequently,800,Human Resources,8,1,Psychology,1,1163,2,Female,48,2,2,HR Specialist,2,Single,3700,11600,1,Y,Yes,23,3,2,80,0,7,6,2,6,4,2,4
46,No,Travel_Rarely,1320,Sales,21,3,Marketing,1,1164,3,Male,85,3,3,Sales Manager,3,Divorced,9400,24800,4,Y,No,14,3,3,80,2,23,2,3,20,15,10,14
31,No,Non-Travel,840,Research & Development,9,3,Life Sciences,1,1165,4,Female,53,4,1,Laboratory Technician,4,Single,4200,13800,3,Y,No,22,4,4,80,1,8,4,4,6,4,2,4
48,Yes,Travel_Rarely,1360,Sales,23,4,Business,1,1166,1,Male,86,1,2,Sales Executive,1,Married,8200,21400,7,Y,Yes,18,3,1,80,1,25,2,1,22,17,11,15
25,No,Travel_Frequently,660,Research & Development,5,2,Technical Degree,1,1167,2,Female,39,2,1,Research Scientist,2,Divorced,3100,8900,0,Y,No,24,3,2,80,1,2,5,2,1,0,0,0
51,No,Travel_Rarely,1420,Human Resources,26,4,Human Resources,1,1168,4,Male,93,4,5,HR Director,4,Single,19400,43400,8,Y,No,17,4,4,80,3,28,1,4,25,19,14,18
29,Yes,Travel_Frequently,780,Sales,7,3,Life Sciences,1,1169,3,Female,46,3,2,Sales Representative,3,Married,4600,14600,1,Y,Yes,19,3,3,80,1,6,4,3,4,3,1,3
42,No,Travel_Rarely,1240,Research & Development,18,4,Medical,1,1170,2,Male,77,2,3,Healthcare Representative,2,Single,7900,26600,5,Y,No,21,3,2,80,2,19,3,2,16,12,7,11
27,No,Non-Travel,720,Sales,6,2,Marketing,1,1171,4,Female,43,4,1,Sales Executive,4,Divorced,3700,10800,1,Y,No,20,4,4,80,1,4,5,4,3,2,1,2
47,Yes,Travel_Rarely,1340,Research & Development,22,5,Engineering,1,1172,1,Male,89,1,4,Research Director,1,Married,17600,39800,6,Y,Yes,16,3,1,80,2,24,2,1,21,16,12,16
32,No,Travel_Frequently,860,Human Resources,11,2,Psychology,1,1173,3,Female,54,3,2,HR Specialist,3,Single,3800,12200,2,Y,No,18,3,3,80,1,9,4,3,7,5,2,4
44,No,Travel_Rarely,1280,Sales,20,3,Business,1,1174,4,Male,81,4,3,Sales Manager,4,Divorced,9200,24200,5,Y,No,15,4,4,80,2,21,2,4,18,14,8,12
28,Yes,Travel_Frequently,760,Research & Development,8,3,Life Sciences,1,1175,2,Female,45,2,1,Laboratory Technician,2,Married,3900,12400,2,Y,Yes,23,3,2,80,1,5,5,2,4,3,1,3
53,No,Travel_Rarely,1440,Sales,26,4,Marketing,1,1176,3,Male,90,3,2,Sales Executive,3,Single,10400,27600,8,Y,No,12,3,3,80,1,30,2,3,27,22,16,20
26,No,Non-Travel,680,Research & Development,4,2,Technical Degree,1,1177,4,Female,40,4,1,Research Scientist,4,Divorced,2800,8200,0,Y,No,25,4,4,80,1,3,6,4,2,1,0,1
49,Yes,Travel_Rarely,1380,Human Resources,24,4,Human Resources,1,1178,1,Male,87,1,5,HR Manager,1,Single,16600,36800,7,Y,Yes,19,3,1,80,3,26,1,1,23,17,12,16
35,No,Travel_Frequently,900,Sales,12,3,Life Sciences,1,1179,2,Female,57,2,2,Sales Representative,2,Married,5300,17200,3,Y,No,17,3,2,80,1,12,3,2,9,7,3,6
41,No,Travel_Rarely,1220,Research & Development,17,4,Medical,1,1180,4,Male,76,4,3,Healthcare Representative,4,Single,8100,27200,4,Y,No,20,4,4,80,2,18,3,4,15,11,6,10
23,Yes,Travel_Frequently,560,Sales,3,1,Business,1,1181,3,Female,32,3,1,Sales Executive,3,Divorced,2900,7800,0,Y,Yes,24,3,3,80,0,1,6,3,0,0,0,0
56,No,Travel_Rarely,1460,Research & Development,29,5,Engineering,1,1182,2,Male,96,2,4,Research Director,2,Married,20200,45400,9,Y,No,14,3,2,80,2,33,2,2,30,25,19,23
30,No,Non-Travel,820,Human Resources,9,2,Psychology,1,1183,4,Female,49,4,2,HR Specialist,4,Single,3600,10600,1,Y,No,22,4,4,80,0,7,6,4,5,4,1,4
38,Yes,Travel_Rarely,1160,Sales,15,3,Marketing,1,1184,1,Male,74,1,3,Sales Manager,1,Married,8400,22000,3,Y,Yes,18,3,1,80,2,15,2,1,13,9,5,8
34,No,Travel_Frequently,880,Research & Development,13,3,Life Sciences,1,1185,3,Female,56,3,1,Laboratory Technician,3,Divorced,4400,15200,4,Y,No,16,3,3,80,1,11,3,3,8,6,2,5
46,No,Travel_Rarely,1320,Sales,21,4,Business,1,1186,4,Male,84,4,2,Sales Executive,4,Single,8800,23000,6,Y,No,21,4,4,80,1,23,2,4,20,15,10,14
22,Yes,Travel_Frequently,540,Research & Development,2,1,Technical Degree,1,1187,2,Female,31,2,1,Research Scientist,2,Married,2500,6800,0,Y,Yes,25,3,2,80,0,0,5,2,0,0,0,0
52,No,Travel_Rarely,1420,Human Resources,25,4,Human Resources,1,1188,3,Male,91,3,5,HR Director,3,Divorced,18600,41600,8,Y,No,15,3,3,80,3,29,1,3,26,20,15,19
31,No,Non-Travel,840,Sales,10,3,Life Sciences,1,1189,4,Female,54,4,2,Sales Representative,4,Single,5000,16000,2,Y,No,19,4,4,80,1,8,4,4,6,4,2,4
37,Yes,Travel_Rarely,1140,Research & Development,14,4,Medical,1,1190,1,Male,72,1,3,Healthcare Representative,1,Married,7600,25800,3,Y,Yes,20,3,1,80,2,14,3,1,12,8,4,7
24,No,Travel_Frequently,620,Sales,3,2,Marketing,1,1191,2,Female,35,2,1,Sales Executive,2,Divorced,3300,9400,0,Y,No,23,3,2,80,1,2,5,2,1,0,0,0
50,No,Travel_Rarely,1400,Research & Development,24,5,Engineering,1,1192,4,Male,90,4,4,Research Director,4,Single,18400,40800,7,Y,No,17,4,4,80,2,27,2,4,24,18,13,17
27,Yes,Travel_Frequently,720,Human Resources,5,1,Psychology,1,1193,3,Female,42,3,2,HR Specialist,3,Married,3200,8800,0,Y,Yes,24,3,3,80,0,4,6,3,3,2,1,2
43,No,Travel_Rarely,1260,Sales,19,3,Business,1,1194,2,Male,80,2,3,Sales Manager,2,Divorced,9000,23600,5,Y,No,18,3,2,80,2,20,2,2,17,13,8,11
29,No,Non-Travel,780,Research & Development,7,3,Life Sciences,1,1195,4,Female,47,4,1,Laboratory Technician,4,Single,4100,13600,2,Y,No,21,4,4,80,1,6,4,4,4,3,1,3
48,Yes,Travel_Rarely,1360,Sales,23,4,Marketing,1,1196,1,Male,85,1,2,Sales Executive,1,Married,8600,22200,6,Y,Yes,16,3,1,80,1,25,2,1,22,17,11,15
25,No,Travel_Frequently,660,Research & Development,4,2,Technical Degree,1,1197,3,Female,38,3,1,Research Scientist,3,Divorced,3000,8600,1,Y,No,22,3,3,80,1,2,5,3,1,0,0,0
54,No,Travel_Rarely,1440,Human Resources,27,4,Human Resources,1,1198,4,Male,93,4,5,HR Manager,4,Single,19000,42200,9,Y,No,13,4,4,80,3,31,1,4,28,22,16,20
33,Yes,Travel_Frequently,860,Sales,11,3,Life Sciences,1,1199,2,Female,55,2,2,Sales Representative,2,Married,5100,16800,3,Y,Yes,19,3,2,80,1,10,3,2,8,6,2,5
39,No,Non-Travel,1160,Research & Development,16,4,Medical,1,1200,4,Male,73,4,3,Healthcare Representative,4,Single,7200,24600,4,Y,No,20,4,4,80,2,16,3,4,13,9,5,8
42,No,Travel_Rarely,892,Sales,3,3,Business,1,1001,3,Female,65,2,3,Sales Executive,3,Married,12500,15000,3,Y,No,18,3,3,80,2,15,3,3,12,8,4,7
35,Yes,Non-Travel,1200,Research & Development,15,2,Engineering,1,1002,2,Male,55,4,1,Research Scientist,2,Single,3800,22000,1,Y,Yes,22,4,2,80,0,8,2,2,5,3,1,2
48,No,Travel_Frequently,756,Human Resources,8,4,Psychology,1,1003,4,Female,75,3,4,HR Manager,4,Divorced,18200,12500,5,Y,No,16,3,4,80,1,22,4,4,18,12,6,10
29,No,Travel_Rarely,445,Research & Development,12,3,Engineering,1,1004,3,Male,42,3,2,Laboratory Technician,3,Married,6800,18000,2,Y,Yes,14,3,3,80,1,6,3,3,4,2,1,2
51,Yes,Travel_Frequently,1350,Sales,25,1,Marketing,1,1005,1,Female,88,2,5,Manager,2,Divorced,25000,8900,8,Y,No,25,4,1,80,3,28,1,4,15,10,8,12
26,No,Non-Travel,650,Research & Development,6,2,Life Sciences,1,1006,4,Male,38,4,1,Research Scientist,4,Single,4200,19500,0,Y,No,12,3,4,80,0,3,4,4,2,1,0,1
37,No,Travel_Rarely,980,Sales,18,3,Business,1,1007,2,Female,68,3,3,Sales Representative,2,Married,9500,14200,4,Y,Yes,20,3,2,80,2,14,2,3,11,7,5,8
44,Yes,Travel_Frequently,820,Human Resources,7,4,Psychology,1,1008,3,Male,52,2,2,HR Representative,3,Single,8900,16800,6,Y,No,17,3,3,80,1,19,3,2,12,9,3,6
33,No,Travel_Rarely,1100,Research & Development,22,2,Engineering,1,1009,4,Female,71,3,4,Manufacturing Director,4,Married,16500,11200,3,Y,Yes,19,3,4,80,2,11,4,4,8,6,2,5
28,No,Non-Travel,590,Sales,4,3,Marketing,1,1010,2,Male,45,4,1,Sales Executive,2,Divorced,5600,20800,1,Y,No,15,3,2,80,0,5,2,2,3,2,1,1
39,Yes,Travel_Rarely,1250,Research & Development,14,4,Medical,1,1011,1,Female,82,3,3,Healthcare Representative,1,Single,11200,9800,7,Y,Yes,23,4,1,80,1,16,1,3,9,5,4,7
46,No,Travel_Frequently,710,Sales,9,2,Business,1,1012,3,Male,59,2,4,Manager,3,Married,19800,13600,5,Y,No,21,3,3,80,3,23,3,4,20,14,9,11
31,No,Travel_Rarely,875,Human Resources,16,3,Psychology,1,1013,4,Female,48,4,2,HR Specialist,4,Single,7300,1740,5,Y,Yes,4,3,4,80,1,11,4,4,8,5,3,6
28,Yes,Non-Travel,895,Sales,7,4,Business,1,1202,1,Male,63,2,4,Sales Executive,1,Married,12800,11600,5,Y,No,18,3,1,80,2,17,1,1,11,8,5,9
27,No,Travel_Rarely,505,Research & Development,22,1,Engineering,1,1203,3,Female,35,4,2,Laboratory Technician,3,Single,5400,20200,1,Y,Yes,13,3,3,80,0,4,3,3,2,1,0,1
54,No,Travel_Frequently,1375,Human Resources,4,2,Psychology,1,1204,2,Male,87,2,5,HR Manager,2,Divorced,25600,7800,10,Y,No,31,4,2,80,3,31,2,4,24,18,12,20
31,Yes,Travel_Rarely,625,Sales,18,3,Marketing,1,1205,4,Female,43,4,3,Sales Representative,4,Married,8200,16400,3,Y,Yes,16,3,4,80,1,8,4,4,5,3,2,3
42,No,Non-Travel,945,Research & Development,25,4,Life Sciences,1,1206,1,Male,67,2,3,Research Scientist,1,Single,13600,11800,6,Y,No,20,3,1,80,2,19,1,1,13,9,6,10
29,No,Travel_Rarely,545,Human Resources,11,1,Psychology,1,1207,3,Female,38,4,2,HR Representative,3,Divorced,6800,18600,2,Y,Yes,14,3,3,80,0,6,3,3,4,2,1,2
48,Yes,Travel_Frequently,1155,Sales,28,2,Business,1,1208,2,Male,75,3,5,Manager,2,Married,22800,8400,8,Y,No,25,4,2,80,3,25,2,4,18,13,9,15
34,No,Travel_Rarely,705,Research & Development,14,3,Engineering,1,1209,4,Female,48,3,2,Laboratory Technician,4,Single,8600,15800,4,Y,Yes,15,3,4,80,1,11,4,4,8,5,3,6
37,No,Non-Travel,825,Human Resources,21,4,Psychology,1,1210,3,Male,57,2,4,HR Specialist,3,Married,11400,12200,5,Y,No,18,3,3,80,2,14,3,3,10,7,4,8
26,Yes,Travel_Rarely,455,Sales,6,1,Marketing,1,1211,1,Female,33,4,1,Sales Executive,1,Single,4800,22800,0,Y,Yes,11,3,1,80,0,3,1,1,2,1,0,1
51,No,Travel_Frequently,1265,Research & Development,19,2,Life Sciences,1,1212,2,Male,79,2,4,Healthcare Representative,2,Divorced,19400,9200,7,Y,No,26,4,2,80,3,28,2,4,20,15,10,17
35,No,Travel_Rarely,755,Human Resources,26,3,Psychology,1,1213,4,Female,52,3,3,HR Representative,4,Single,9800,14600,3,Y,Yes,17,3,4,80,1,12,4,4,8,5,4,6
32,Yes,Non-Travel,645,Sales,8,4,Business,1,1214,3,Male,44,4,2,Sales Representative,3,Married,7800,17600,2,Y,No,15,3,3,80,3,9,3,3,6,4,2,4
44,No,Travel_Rarely,1015,Research & Development,23,1,Engineering,1,1215,1,Female,68,2,5,Manufacturing Director,1,Single,17200,10200,6,Y,Yes,21,4,1,80,3,21,1,1,15,11,7,12
28,No,Travel_Frequently,535,Human Resources,12,2,Psychology,1,1216,2,Male,37,4,1,HR Representative,2,Divorced,6400,19200,1,Y,No,13,3,2,80,0,5,2,2,3,2,1,2
49,Yes,Travel_Rarely,1195,Sales,29,3,Marketing,1,1217,4,Female,76,3,4,Sales Executive,4,Married,19800,9000,7,Y,Yes,24,4,4,80,2,26,4,4,19,14,9,16
36,No,Non-Travel,785,Research & Development,15,4,Life Sciences,1,1218,3,Male,54,2,3,Research Scientist,3,Single,10800,12600,4,Y,No,18,3,3,80,2,13,3,3,9,6,4,7
33,No,Travel_Rarely,685,Human Resources,27,1,Psychology,1,1219,1,Female,46,4,2,HR Specialist,1,Married,8400,16200,3,Y,Yes,16,3,1,80,0,10,1,1,7,4,3,5
41,Yes,Travel_Frequently,925,Sales,3,2,Business,1,1220,2,Male,65,2,5,Manager,2,Divorced,21600,8600,8,Y,No,23,4,2,80,3,18,2,4,12,9,6,10
30,No,Travel_Rarely,585,Research & Development,20,3,Engineering,1,1221,4,Female,40,3,2,Laboratory Technician,4,Single,7400,18200,2,Y,Yes,15,3,4,80,1,7,4,4,4,3,2,2
47,No,Non-Travel,1145,Human Resources,9,4,Psychology,1,1222,3,Male,73,2,4,HR Manager,3,Married,16200,10400,6,Y,No,22,4,3,80,2,24,3,4,17,12,8,14
25,Yes,Travel_Rarely,445,Sales,22,1,Marketing,1,1223,1,Female,32,4,1,Sales Representative,1,Single,3800,24400,0,Y,Yes,9,3,1,80,0,2,1,1,1,0,0,0
52,No,Travel_Frequently,1295,Research & Development,5,2,Life Sciences,1,1224,2,Male,82,2,5,Research Director,2,Single,24800,8000,9,Y,No,29,4,2,80,3,29,2,4,22,16,11,18
38,No,Travel_Rarely,815,Human Resources,18,3,Psychology,1,1225,4,Female,58,2,3,HR Representative,4,Married,11200,12800,5,Y,Yes,19,3,4,80,2,15,4,4,11,8,5,9
31,Yes,Non-Travel,615,Sales,24,4,Business,1,1226,3,Male,42,4,2,Sales Executive,3,Divorced,8600,15800,3,Y,No,16,3,3,80,1,8,3,3,5,3,2,3
43,No,Travel_Rarely,975,Research & Development,13,1,Engineering,1,1227,1,Female,67,2,4,Manufacturing Director,1,Married,15800,10600,5,Y,Yes,20,4,1,80,3,20,1,1,14,10,7,11
29,No,Travel_Frequently,525,Human Resources,28,2,Psychology,1,1228,2,Male,36,4,1,HR Representative,2,Single,6200,20200,1,Y,No,14,3,2,80,0,6,2,2,4,2,1,2
46,Yes,Travel_Rarely,1125,Sales,7,3,Marketing,1,1229,4,Female,72,3,4,Sales Executive,4,Married,18400,9200,6,Y,Yes,23,4,4,80,2,23,4,4,16,11,8,13
34,No,Non-Travel,715,Research & Development,21,4,Life Sciences,1,1230,3,Male,49,2,3,Research Scientist,3,Single,9400,14200,4,Y,No,17,3,3,80,2,11,3,3,8,5,4,6
39,No,Travel_Rarely,855,Human Resources,16,1,Psychology,1,1231,1,Female,60,4,2,HR Specialist,1,Divorced,10600,13000,5,Y,Yes,18,3,1,80,0,16,1,1,11,8,5,9
27,Yes,Travel_Frequently,485,Sales,25,2,Business,1,1232,2,Male,35,3,1,Sales Representative,2,Single,5200,21200,0,Y,No,12,3,2,80,0,4,2,2,2,1,0,1
50,No,Travel_Rarely,1225,Research & Development,10,3,Engineering,1,1233,4,Female,78,2,5,Manufacturing Director,4,Married,22400,8800,8,Y,Yes,26,4,4,80,2,27,4,4,20,15,10,17
35,No,Non-Travel,745,Human Resources,26,4,Psychology,1,1234,3,Male,51,2,3,HR Representative,3,Single,9800,14600,4,Y,No,17,3,3,80,2,12,3,3,8,5,4,6
32,Yes,Travel_Rarely,635,Sales,4,1,Marketing,1,1235,1,Female,44,4,2,Sales Executive,1,Married,8200,16400,2,Y,Yes,15,3,1,80,1,9,1,1,6,4,3,4
45,No,Travel_Frequently,1055,Research & Development,19,2,Life Sciences,1,1236,2,Male,70,2,4,Healthcare Representative,2,Divorced,16800,10000,6,Y,No,21,4,2,80,3,22,2,4,15,11,7,12
28,No,Travel_Rarely,515,Human Resources,23,3,Psychology,1,1237,4,Female,36,4,1,HR Representative,4,Single,6000,20400,1,Y,Yes,13,3,4,80,0,5,4,4,3,2,1,2
53,Yes,Travel_Rarely,1345,Sales,8,4,Business,1,1238,3,Male,84,3,5,Sales Director,3,Married,27200,7200,10,Y,No,30,4,3,80,3,30,3,4,23,17,12,19
37,No,Non-Travel,785,Research & Development,17,1,Engineering,1,1239,1,Female,55,2,3,Laboratory Technician,1,Single,9600,14800,3,Y,Yes,18,3,1,80,3,14,1,1,10,6,4,8
33,No,Travel_Frequently,665,Human Resources,29,2,Psychology,1,1240,2,Male,46,3,2,HR Specialist,2,Married,8800,15600,4,Y,No,16,3,2,80,2,10,2,2,7,5,3,5
42,Yes,Travel_Rarely,945,Sales,6,3,Marketing,1,1241,4,Female,66,2,4,Sales Executive,4,Divorced,15400,10200,5,Y,Yes,20,4,4,80,2,19,4,4,13,9,6,10
26,No,Non-Travel,435,Research & Development,20,4,Life Sciences,1,1242,3,Male,32,4,1,Research Scientist,3,Single,4600,22600,0,Y,No,11,3,3,80,1,3,3,3,2,1,0,1
49,No,Travel_Rarely,1175,Human Resources,12,1,Psychology,1,1243,1,Female,76,2,5,HR Manager,1,Married,20400,9000,7,Y,Yes,24,4,1,80,3,26,1,1,19,14,9,16
34,Yes,Travel_Frequently,695,Sales,24,2,Business,1,1244,2,Male,48,4,3,Sales Representative,2,Single,9200,14400,3,Y,No,17,3,2,80,1,11,2,2,8,5,4,6
31,No,Travel_Rarely,605,Research & Development,14,3,Engineering,1,1245,4,Female,42,3,2,Laboratory Technician,4,Married,7800,17600,2,Y,Yes,15,3,4,80,1,8,4,4,5,3,2,3
44,No,Non-Travel,1005,Human Resources,27,4,Psychology,1,1246,3,Male,68,2,4,HR Specialist,3,Divorced,13400,11800,6,Y,No,19,3,3,80,2,21,3,3,15,11,7,12
29,Yes,Travel_Rarely,535,Sales,3,1,Marketing,1,1247,1,Female,37,4,1,Sales Executive,1,Single,6600,19800,1,Y,Yes,14,3,1,80,0,6,1,1,4,2,1,2
48,No,Travel_Frequently,1165,Research & Development,18,2,Life Sciences,1,1248,2,Male,74,2,5,Research Director,2,Married,21600,8800,7,Y,No,25,4,2,80,3,25,2,4,18,13,9,15
35,No,Travel_Rarely,735,Human Resources,25,3,Psychology,1,1249,4,Female,50,3,3,HR Representative,4,Single,9600,14800,4,Y,Yes,17,3,4,80,1,12,4,4,8,5,4,6
40,Yes,Non-Travel,885,Sales,9,4,Business,1,1250,3,Male,62,2,4,Sales Executive,3,Married,13200,11400,5,Y,No,18,3,3,80,2,17,3,3,11,8,5,9
32,No,Travel_Rarely,625,Research & Development,22,1,Engineering,1,1251,1,Female,43,3,2,Laboratory Technician,1,Divorced,7600,18000,2,Y,Yes,15,3,1,80,3,9,1,1,6,4,3,4
46,No,Travel_Frequently,1095,Human Resources,5,2,Psychology,1,1252,2,Male,71,2,4,HR Manager,2,Single,17800,9800,6,Y,No,22,4,2,80,2,23,2,4,16,11,8,13
27,Yes,Travel_Rarely,485,Sales,19,3,Marketing,1,1253,4,Female,35,4,2,Sales Representative,4,Married,5600,20800,1,Y,Yes,13,3,4,80,0,4,4,4,2,1,0,1
51,No,Non-Travel,1235,Research & Development,13,4,Life Sciences,1,1254,3,Male,79,2,5,Healthcare Representative,3,Single,22800,8400,8,Y,No,27,4,3,80,2,28,3,4,20,15,10,17
36,No,Travel_Rarely,765,Human Resources,26,1,Psychology,1,1255,1,Female,53,4,3,HR Specialist,1,Married,10200,13400,4,Y,Yes,18,3,1,80,0,13,1,1,9,6,4,7
33,Yes,Travel_Frequently,675,Sales,10,2,Business,1,1256,2,Male,46,3,2,Sales Executive,2,Divorced,8800,15600,3,Y,No,16,3,2,80,2,10,2,2,7,5,3,5
41,No,Travel_Rarely,925,Research & Development,23,3,Engineering,1,1257,4,Female,64,2,4,Manufacturing Director,4,Single,15600,10800,5,Y,Yes,20,4,4,80,2,18,4,4,12,9,6,10
28,No,Non-Travel,525,Human Resources,7,4,Psychology,1,1258,3,Male,36,4,1,HR Representative,3,Married,6400,19600,1,Y,No,14,3,3,80,3,5,3,3,3,2,1,2
47,Yes,Travel_Rarely,1135,Sales,21,1,Marketing,1,1259,1,Female,73,2,5,Manager,1,Single,20800,8600,7,Y,Yes,23,4,1,80,3,24,1,1,17,12,8,14
34,No,Travel_Frequently,695,Research & Development,15,2,Life Sciences,1,1260,2,Male,47,3,3,Research Scientist,2,Married,9800,14600,4,Y,No,17,3,2,80,2,11,2,2,8,5,4,6
39,No,Travel_Rarely,835,Human Resources,28,3,Psychology,1,1261,4,Female,58,2,4,HR Representative,4,Divorced,11800,12600,5,Y,Yes,19,3,4,80,2,16,4,4,11,8,5,9
25,Yes,Non-Travel,425,Sales,4,1,Business,1,1262,3,Male,31,4,1,Sales Representative,3,Single,4200,23800,0,Y,No,10,3,3,80,0,2,3,3,1,0,0,0
52,No,Travel_Rarely,1275,Research & Development,17,4,Engineering,1,1263,1,Female,81,2,5,Manufacturing Director,1,Married,24200,8200,8,Y,Yes,28,4,1,80,3,29,1,1,22,16,11,18
37,No,Travel_Frequently,795,Human Resources,24,2,Psychology,1,1264,2,Male,55,3,3,HR Specialist,2,Single,10800,13200,4,Y,No,18,3,2,80,2,14,2,2,10,7,4,8
30,Yes,Travel_Rarely,565,Sales,11,3,Marketing,1,1265,4,Female,39,4,2,Sales Executive,4,Married,7800,17800,2,Y,Yes,15,3,4,80,1,7,4,4,4,3,2,2
45,No,Non-Travel,1025,Research & Development,25,1,Life Sciences,1,1266,3,Male,69,2,4,Healthcare Representative,3,Divorced,16400,10400,6,Y,No,21,4,3,80,2,22,3,4,15,11,7,12
31,No,Travel_Rarely,595,Human Resources,8,4,Psychology,1,1267,1,Female,41,4,2,HR Representative,1,Single,7400,18200,2,Y,Yes,16,3,1,80,0,8,1,1,5,3,2,3
54,Yes,Travel_Frequently,1355,Sales,20,2,Business,1,1268,2,Male,85,3,5,Sales Director,2,Married,26800,7600,9,Y,No,31,4,2,80,3,31,2,4,24,18,12,20
38,No,Travel_Rarely,825,Research & Development,14,3,Engineering,1,1269,4,Female,57,2,3,Laboratory Technician,4,Single,10400,13200,4,Y,Yes,18,3,4,80,1,15,4,4,11,7,5,9
32,No,Non-Travel,645,Human Resources,29,1,Psychology,1,1270,3,Male,44,4,2,HR Specialist,3,Married,8200,16200,3,Y,No,16,3,3,80,3,9,3,3,6,4,3,4
43,Yes,Travel_Rarely,985,Sales,6,4,Marketing,1,1271,1,Female,67,2,4,Sales Executive,1,Divorced,16800,10000,5,Y,Yes,20,4,1,80,2,20,1,1,14,10,7,11
29,No,Travel_Frequently,535,Research & Development,22,2,Life Sciences,1,1272,2,Male,37,3,2,Research Scientist,2,Single,8200,16400,1,Y,No,15,3,2,80,2,6,2,2,4,3,1,2
48,No,Travel_Rarely,1155,Human Resources,3,3,Psychology,1,1273,4,Female,75,2,4,HR Manager,4,Married,18600,9800,7,Y,Yes,24,4,4,80,2,25,4,4,18,13,9,15
35,Yes,Non-Travel,725,Sales,16,1,Business,1,1274,3,Male,50,4,3,Sales Representative,3,Single,9400,14200,3,Y,No,17,3,3,80,1,12,3,3,8,5,4,6
26,No,Travel_Rarely,445,Research & Development,27,4,Engineering,1,1275,1,Female,33,3,1,Laboratory Technician,1,Married,4800,22400,0,Y,Yes,12,3,1,80,0,3,1,1,2,1,0,1
50,No,Travel_Frequently,1215,Human Resources,12,2,Psychology,1,1276,2,Male,78,2,5,HR Manager,2,Divorced,21800,8600,8,Y,No,27,4,2,80,3,27,2,4,20,15,10,17
36,Yes,Travel_Rarely,785,Sales,26,3,Marketing,1,1277,4,Female,54,3,4,Sales Executive,4,Single,11200,12800,4,Y,Yes,18,3,4,80,1,13,4,4,9,6,4,7
41,No,Non-Travel,915,Research & Development,9,4,Life Sciences,1,1278,3,Male,64,2,3,Healthcare Representative,3,Married,14600,11200,5,Y,No,20,3,3,80,2,18,3,3,12,9,6,10
33,No,Travel_Rarely,675,Human Resources,23,1,Psychology,1,1279,1,Female,46,4,2,HR Representative,1,Divorced,8600,15800,3,Y,Yes,16,3,1,80,0,10,1,1,7,4,3,5
28,Yes,Travel_Frequently,515,Sales,5,2,Business,1,1280,2,Male,36,4,1,Sales Representative,2,Single,5800,20600,0,Y,No,13,3,2,80,0,5,2,2,3,2,1,2
47,No,Travel_Rarely,1125,Research & Development,19,3,Engineering,1,1281,4,Female,72,2,5,Manufacturing Director,4,Married,19400,9200,6,Y,Yes,23,4,4,80,2,24,4,4,17,12,8,14
34,No,Non-Travel,685,Human Resources,28,4,Psychology,1,1282,3,Male,47,2,3,HR Specialist,3,Single,9200,14400,4,Y,No,17,3,3,80,2,11,3,3,8,5,4,6
39,Yes,Travel_Rarely,845,Sales,13,1,Marketing,1,1283,1,Female,59,4,2,Sales Executive,1,Married,12400,12200,3,Y,Yes,19,3,1,80,1,16,1,1,11,8,5,9
26,No,Travel_Frequently,455,Research & Development,25,2,Life Sciences,1,1284,2,Male,33,3,1,Research Scientist,2,Single,5200,21200,0,Y,No,11,3,2,80,0,3,2,2,2,1,0,1
51,No,Travel_Rarely,1245,Human Resources,7,3,Psychology,1,1285,4,Female,79,2,4,HR Manager,4,Divorced,22200,8400,8,Y,Yes,26,4,4,80,2,28,4,4,20,15,10,17
37,Yes,Non-Travel,805,Sales,21,4,Business,1,1286,3,Male,56,2,4,Sales Executive,3,Single,11800,12600,4,Y,No,18,3,3,80,2,14,3,3,10,7,4,8
32,No,Travel_Rarely,615,Research & Development,15,1,Engineering,1,1287,1,Female,42,4,2,Laboratory Technician,1,Married,7200,18400,2,Y,Yes,15,3,1,80,3,9,1,1,6,4,3,4
44,No,Travel_Frequently,995,Human Resources,29,2,Psychology,1,1288,2,Male,68,2,4,HR Representative,2,Single,15800,10000,5,Y,No,21,4,2,80,2,21,2,4,15,11,7,12
29,Yes,Travel_Rarely,545,Sales,10,3,Marketing,1,1289,4,Female,38,4,3,Sales Representative,4,Married,7200,18000,1,Y,Yes,14,3,4,80,1,6,4,4,4,3,2,2
48,No,Non-Travel,1165,Research & Development,22,4,Life Sciences,1,1290,3,Male,74,2,5,Research Director,3,Divorced,20800,8800,7,Y,No,25,4,3,80,2,25,3,4,18,13,9,15
35,No,Travel_Rarely,745,Human Resources,4,1,Psychology,1,1291,1,Female,51,4,3,HR Specialist,1,Single,9800,14600,3,Y,Yes,17,3,1,80,0,12,1,1,8,5,4,6
30,Yes,Travel_Frequently,575,Sales,18,2,Business,1,1292,2,Male,40,3,2,Sales Executive,2,Married,8400,16200,2,Y,No,15,3,2,80,2,7,2,2,4,3,2,2
42,No,Travel_Rarely,935,Research & Development,26,3,Engineering,1,1293,4,Female,65,2,4,Manufacturing Director,4,Single,15200,10400,5,Y,Yes,20,4,4,80,2,19,4,4,13,9,6,10
27,No,Non-Travel,485,Human Resources,11,4,Psychology,1,1294,3,Male,35,4,1,HR Representative,3,Divorced,6000,20000,1,Y,No,13,3,3,80,3,4,3,3,2,1,0,1
53,Yes,Travel_Rarely,1325,Sales,24,1,Marketing,1,1295,1,Female,83,2,5,Manager,1,Married,25600,7600,9,Y,Yes,29,4,1,80,3,30,1,1,23,17,12,19
36,No,Travel_Frequently,775,Research & Development,8,2,Life Sciences,1,1296,2,Male,53,3,3,Healthcare Representative,2,Single,11200,13200,4,Y,No,18,3,2,80,2,13,2,2,9,6,4,7
33,No,Travel_Rarely,665,Human Resources,20,3,Psychology,1,1297,4,Female,46,2,3,HR Representative,4,Married,8800,15600,3,Y,Yes,16,3,4,80,1,10,4,4,7,4,3,5
40,Yes,Non-Travel,885,Sales,14,4,Business,1,1298,3,Male,62,2,4,Sales Executive,3,Divorced,13800,11600,5,Y,No,19,3,3,80,2,17,3,3,11,8,5,9
28,No,Travel_Rarely,525,Research & Development,27,1,Engineering,1,1299,1,Female,36,4,2,Laboratory Technician,1,Single,6200,20200,1,Y,Yes,14,3,1,80,0,5,1,1,3,2,1,2
46,No,Travel_Frequently,1105,Human Resources,2,2,Psychology,1,1300,2,Male,71,2,5,HR Manager,2,Married,19600,9000,6,Y,No,23,4,2,80,3,23,2,4,16,11,8,130,2,Y,Yes,13,3,4,80,1,8,4,4,6,4,2,3
25,Yes,Non-Travel,420,Research & Development,28,1,Engineering,1,1014,2,Male,33,3,1,Laboratory Technician,2,Married,3900,25200,0,Y,No,11,3,2,80,0,2,3,2,1,0,0,0
54,No,Travel_Rarely,1400,Sales,5,4,Marketing,1,1015,3,Female,78,2,5,Sales Director,3,Divorced,22500,10800,6,Y,Yes,24,4,3,80,2,31,2,4,25,18,12,15
32,No,Travel_Frequently,695,Research & Development,11,3,Life Sciences,1,1016,4,Male,61,4,2,Research Scientist,4,Married,8700,15900,3,Y,No,16,3,4,80,1,9,4,4,7,5,1,4
40,Yes,Travel_Rarely,950,Human Resources,19,2,Psychology,1,1017,2,Female,73,3,3,HR Manager,2,Single,14600,12700,4,Y,Yes,18,3,2,80,2,17,2,3,11,8,6,9
27,No,Non-Travel,580,Sales,21,3,Business,1,1018,3,Male,39,4,1,Sales Representative,3,Divorced,4800,21600,1,Y,No,12,3,3,80,0,4,4,3,2,1,0,1
49,No,Travel_Rarely,1180,Research & Development,13,4,Engineering,1,1019,1,Female,86,2,4,Manufacturing Director,1,Married,17900,9400,8,Y,Yes,22,4,1,80,3,26,1,4,18,13,7,14
36,Yes,Travel_Frequently,765,Sales,7,2,Marketing,1,1020,4,Male,54,3,2,Sales Executive,4,Single,10300,16200,5,Y,No,19,3,4,80,1,13,4,4,9,6,3,7
30,No,Travel_Rarely,850,Human Resources,24,3,Psychology,1,1021,3,Female,47,4,3,HR Representative,3,Married,9800,14800,2,Y,Yes,15,3,3,80,2,7,3,3,5,3,2,2
45,No,Non-Travel,1320,Research & Development,2,4,Medical,1,1022,2,Male,79,3,5,Research Director,2,Divorced,24800,8600,7,Y,No,26,4,2,80,3,22,2,4,16,11,9,13
23,Yes,Travel_Rarely,465,Sales,17,1,Business,1,1023,4,Female,35,4,1,Sales Representative,4,Single,3600,23400,0,Y,Yes,10,3,4,80,0,1,4,4,0,0,0,0
52,No,Travel_Frequently,1150,Human Resources,8,3,Psychology,1,1024,1,Male,69,2,4,HR Manager,1,Married,16800,11600,6,Y,No,20,3,1,80,2,29,1,4,22,16,8,18
34,No,Travel_Rarely,720,Research & Development,15,2,Engineering,1,1025,3,Female,51,3,2,Laboratory Technician,3,Single,6200,18600,3,Y,Yes,14,3,3,80,1,11,3,3,8,5,3,6
41,Yes,Non-Travel,1080,Sales,26,4,Marketing,1,1026,4,Male,74,4,3,Sales Executive,4,Married,13800,10200,4,Y,No,21,3,4,80,2,18,4,4,12,8,5,10
29,No,Travel_Rarely,625,Human Resources,4,3,Psychology,1,1027,2,Female,43,3,2,HR Specialist,2,Divorced,7800,19200,1,Y,Yes,13,3,2,80,1,6,2,2,4,2,1,2
47,No,Travel_Frequently,1275,Research & Development,20,4,Life Sciences,1,1028,3,Male,81,2,4,Healthcare Representative,3,Single,15400,9000,5,Y,No,23,4,3,80,3,24,3,4,17,12,6,11
33,Yes,Travel_Rarely,590,Sales,12,2,Business,1,1029,1,Female,41,4,1,Sales Representative,1,Married,5200,20400,2,Y,Yes,11,3,1,80,0,10,1,1,7,4,2,5
26,No,Non-Travel,785,Research & Development,29,3,Engineering,1,1030,4,Male,56,3,3,Research Scientist,4,Single,8900,15600,0,Y,No,16,3,4,80,1,3,4,4,2,1,0,1
38,No,Travel_Rarely,940,Human Resources,6,4,Psychology,1,1031,2,Female,67,2,2,HR Manager,2,Married,12600,13800,6,Y,Yes,18,3,2,80,2,15,2,2,11,8,4,9
50,Yes,Travel_Frequently,1200,Sales,18,1,Marketing,1,1032,3,Male,85,3,5,Manager,3,Divorced,21400,7800,9,Y,No,27,4,3,80,3,27,3,4,20,15,11,16
24,No,Travel_Rarely,510,Research & Development,23,2,Life Sciences,1,1033,4,Female,36,4,1,Laboratory Technician,4,Single,4100,22800,1,Y,Yes,12,3,4,80,0,1,4,4,0,0,0,0
43,No,Non-Travel,1090,Human Resources,9,3,Psychology,1,1034,1,Male,72,3,3,HR Representative,1,Married,11900,12100,7,Y,No,19,3,1,80,2,20,1,3,15,11,7,12
35,Yes,Travel_Rarely,675,Sales,14,4,Business,1,1035,3,Female,49,4,2,Sales Executive,3,Single,9100,16800,3,Y,Yes,15,3,3,80,1,12,3,3,8,5,2,6
28,No,Travel_Frequently,825,Research & Development,27,2,Engineering,1,1036,2,Male,58,2,4,Manufacturing Director,2,Married,14200,10600,1,Y,No,17,3,2,80,3,5,2,4,3,2,1,2
44,No,Travel_Rarely,1160,Sales,3,3,Marketing,1,1037,4,Female,76,3,4,Sales Executive,4,Divorced,16800,9200,5,Y,Yes,22,4,4,80,2,21,4,4,15,10,8,12
31,Yes,Non-Travel,560,Human Resources,16,1,Psychology,1,1038,3,Male,40,4,1,HR Specialist,3,Single,6400,19800,0,Y,No,13,3,3,80,0,8,3,3,5,3,1,3
39,No,Travel_Rarely,895,Research & Development,21,4,Life Sciences,1,1039,1,Female,66,3,3,Healthcare Representative,1,Married,12800,11400,4,Y,Yes,20,3,1,80,2,16,1,3,10,7,5,8
46,No,Travel_Frequently,1285,Sales,7,2,Business,1,1040,2,Male,83,2,5,Manager,2,Single,23600,8400,6,Y,No,25,4,2,80,3,23,2,4,17,12,9,14
27,Yes,Travel_Rarely,630,Research & Development,25,3,Engineering,1,1041,4,Female,44,4,1,Laboratory Technician,4,Married,4700,21200,2,Y,Yes,14,3,4,80,0,4,4,4,2,1,0,1
48,No,Non-Travel,1105,Human Resources,10,4,Psychology,1,1042,3,Male,71,3,4,HR Manager,3,Divorced,17200,10800,8,Y,No,21,3,3,80,2,25,3,4,19,13,7,15
32,No,Travel_Rarely,745,Sales,19,2,Marketing,1,1043,2,Female,53,4,2,Sales Representative,2,Single,7600,17600,3,Y,Yes,16,3,2,80,1,9,2,2,6,4,2,4
37,Yes,Travel_Frequently,980,Research & Development,8,3,Life Sciences,1,1044,1,Male,68,2,3,Research Scientist,1,Married,10600,13200,5,Y,No,18,3,1,80,3,14,1,3,9,6,4,7
25,No,Travel_Rarely,485,Human Resources,22,1,Psychology,1,1045,4,Female,37,4,2,HR Representative,4,Single,5800,20600,0,Y,Yes,11,3,4,80,0,2,4,4,1,0,0,0
51,No,Non-Travel,1345,Sales,5,4,Business,1,1046,3,Male,87,3,5,Sales Director,3,Married,25800,7600,7,Y,No,28,4,3,80,3,28,3,4,21,16,10,17
29,Yes,Travel_Rarely,695,Research & Development,17,2,Engineering,1,1047,2,Female,50,3,1,Laboratory Technician,2,Divorced,6800,18200,1,Y,Yes,13,3,2,80,1,6,2,2,4,2,1,2
42,No,Travel_Frequently,1155,Human Resources,24,3,Psychology,1,1048,4,Male,75,2,4,HR Manager,4,Single,15600,9800,6,Y,No,19,3,4,80,2,19,4,4,13,9,5,10
34,No,Travel_Rarely,815,Sales,11,4,Marketing,1,1049,1,Female,59,4,3,Sales Executive,1,Married,11200,12800,4,Y,Yes,17,3,1,80,1,11,1,1,8,5,3,6
28,Yes,Non-Travel,575,Research & Development,28,1,Life Sciences,1,1050,3,Male,41,3,2,Research Scientist,3,Single,7200,19600,0,Y,No,15,3,3,80,0,5,3,3,3,2,1,1
45,No,Travel_Rarely,1025,Human Resources,6,2,Psychology,1,1051,2,Female,64,2,3,HR Representative,2,Divorced,13400,11600,5,Y,Yes,20,3,2,80,3,22,2,3,16,11,7,13
36,No,Travel_Frequently,885,Sales,20,3,Business,1,1052,4,Male,62,3,4,Sales Representative,4,Married,9800,14600,3,Y,No,18,3,4,80,2,13,4,4,9,6,3,7
31,Yes,Travel_Rarely,655,Research & Development,13,4,Engineering,1,1053,3,Female,46,4,1,Laboratory Technician,3,Single,5600,20200,2,Y,Yes,12,3,3,80,1,8,3,3,5,3,1,3
49,No,Non-Travel,1275,Human Resources,2,1,Psychology,1,1054,1,Male,78,2,5,HR Manager,1,Married,19200,8800,8,Y,No,24,4,1,80,3,26,1,4,19,14,8,16
26,No,Travel_Rarely,535,Sales,15,2,Marketing,1,1055,4,Female,38,4,2,Sales Representative,4,Single,4400,22600,1,Y,Yes,13,3,4,80,0,3,4,4,2,1,0,1
40,Yes,Travel_Frequently,965,Research & Development,26,3,Life Sciences,1,1056,2,Male,69,3,3,Healthcare Representative,2,Divorced,12600,10400,6,Y,No,21,3,2,80,2,17,2,3,11,8,5,9
33,No,Travel_Rarely,775,Human Resources,9,4,Psychology,1,1057,3,Female,55,2,4,HR Specialist,3,Married,10400,13600,4,Y,Yes,16,3,3,80,1,10,3,3,7,5,2,5
47,No,Non-Travel,1195,Sales,18,2,Business,1,1058,4,Male,81,3,5,Manager,4,Single,22400,7200,7,Y,No,26,4,4,80,3,24,4,4,18,13,9,15
24,Yes,Travel_Rarely,465,Research & Development,21,1,Engineering,1,1059,1,Female,34,4,1,Laboratory Technician,1,Married,3800,24200,0,Y,Yes,10,3,1,80,0,1,1,1,0,0,0,0
52,No,Travel_Frequently,1365,Human Resources,4,3,Psychology,1,1060,3,Male,84,2,4,HR Manager,3,Divorced,18600,9000,9,Y,No,23,4,3,80,2,29,3,4,22,16,10,18
35,No,Travel_Rarely,715,Sales,27,4,Marketing,1,1061,2,Female,52,4,2,Sales Executive,2,Single,8400,16800,3,Y,Yes,14,3,2,80,1,12,2,2,8,5,3,6
30,Yes,Non-Travel,605,Research & Development,12,2,Life Sciences,1,1062,4,Male,43,3,3,Research Scientist,4,Married,8600,15400,1,Y,No,17,3,4,80,3,7,4,4,4,3,1,2
43,No,Travel_Rarely,925,Human Resources,23,3,Psychology,1,1063,1,Female,67,2,3,HR Representative,1,Single,11800,12200,5,Y,Yes,19,3,1,80,2,20,1,3,14,10,6,11
28,No,Travel_Frequently,585,Sales,8,1,Business,1,1064,3,Male,42,4,2,Sales Representative,3,Divorced,6200,19200,2,Y,No,15,3,3,80,0,5,3,3,3,2,1,2
46,Yes,Travel_Rarely,1135,Research & Development,16,4,Engineering,1,1065,2,Female,73,3,4,Manufacturing Director,2,Married,16800,10600,6,Y,Yes,22,4,2,80,2,23,2,4,16,11,7,13
37,No,Non-Travel,825,Human Resources,25,2,Psychology,1,1066,4,Male,58,2,3,HR Specialist,4,Single,9600,14400,4,Y,No,18,3,4,80,1,14,4,4,10,7,4,8
32,No,Travel_Rarely,695,Sales,7,3,Marketing,1,1067,3,Female,49,4,1,Sales Executive,3,Married,7800,17800,3,Y,Yes,13,3,3,80,2,9,3,3,6,4,2,4
41,Yes,Travel_Frequently,1045,Research & Development,19,4,Life Sciences,1,1068,1,Male,71,2,5,Research Director,1,Divorced,21600,8400,8,Y,No,25,4,1,80,3,18,1,4,12,9,6,10
29,No,Travel_Rarely,575,Human Resources,14,1,Psychology,1,1069,2,Female,40,4,2,HR Representative,2,Single,6800,19600,1,Y,Yes,12,3,2,80,0,6,2,2,4,2,1,2
48,No,Non-Travel,1245,Sales,3,2,Business,1,1070,4,Male,79,3,4,Sales Executive,4,Married,18200,9400,7,Y,No,21,3,4,80,2,25,4,4,18,13,8,15
35,No,Travel_Rarely,765,Research & Development,22,3,Engineering,1,1071,3,Female,54,3,3,Laboratory Technician,3,Single,9400,15200,2,Y,Yes,16,3,3,80,1,12,3,3,8,5,3,6
27,Yes,Travel_Frequently,485,Human Resources,10,4,Psychology,1,1072,2,Male,36,4,1,HR Specialist,2,Married,5400,21400,0,Y,No,11,3,2,80,0,4,2,2,2,1,0,1
44,No,Travel_Rarely,1085,Sales,17,2,Marketing,1,1073,1,Female,72,2,5,Manager,1,Divorced,20800,8200,6,Y,Yes,24,4,1,80,3,21,1,4,15,11,7,12
33,No,Non-Travel,635,Research & Development,26,3,Life Sciences,1,1074,4,Male,47,3,2,Research Scientist,4,Single,7600,18400,3,Y,No,14,3,4,80,1,10,4,4,7,4,2,5
50,Yes,Travel_Rarely,1165,Human Resources,5,1,Psychology,1,1075,3,Female,76,2,4,HR Manager,3,Married,16400,10200,8,Y,Yes,23,4,3,80,2,27,3,4,20,15,9,16
26,No,Travel_Frequently,525,Sales,18,2,Business,1,1076,2,Male,39,4,1,Sales Representative,2,Single,4600,22200,1,Y,No,12,3,2,80,0,3,2,2,2,1,0,1
42,No,Travel_Rarely,915,Research & Development,24,4,Engineering,1,1077,4,Female,65,3,3,Manufacturing Director,4,Divorced,14600,11800,5,Y,Yes,20,3,4,80,2,19,4,4,13,9,6,10
31,Yes,Non-Travel,645,Human Resources,11,3,Psychology,1,1078,1,Male,45,4,2,HR Representative,1,Married,7200,17200,2,Y,No,15,3,1,80,1,8,1,1,5,3,2,3
38,No,Travel_Rarely,835,Sales,20,2,Marketing,1,1079,3,Female,59,2,4,Sales Executive,3,Single,11600,13200,4,Y,Yes,18,3,3,80,2,15,3,3,10,7,4,8
45,No,Travel_Frequently,1125,Research & Development,6,4,Life Sciences,1,1080,2,Male,74,3,5,Research Director,2,Married,23800,7800,7,Y,No,27,4,2,80,3,22,2,4,16,11,8,13
28,Yes,Travel_Rarely,555,Human Resources,15,1,Psychology,1,1081,4,Female,38,4,1,HR Specialist,4,Single,5800,20800,0,Y,Yes,13,3,4,80,0,5,4,4,3,2,1,2
53,No,Non-Travel,1295,Sales,29,3,Business,1,1082,3,Male,82,2,5,Sales Director,3,Divorced,26200,7400,9,Y,No,29,4,3,80,3,30,3,4,23,17,11,19
34,No,Travel_Rarely,745,Research & Development,8,2,Engineering,1,1083,1,Female,51,3,2,Laboratory Technician,1,Married,6800,18600,3,Y,Yes,15,3,1,80,3,11,1,1,8,5,3,6
29,Yes,Travel_Frequently,615,Human Resources,23,4,Psychology,1,1084,2,Male,42,4,3,HR Representative,2,Single,8200,16400,1,Y,No,16,3,2,80,0,6,2,2,4,2,1,2
47,No,Travel_Rarely,985,Sales,12,2,Marketing,1,1085,4,Female,68,3,4,Sales Executive,4,Married,15800,9600,6,Y,Yes,21,3,4,80,2,24,4,4,17,12,8,14
36,No,Non-Travel,725,Research & Development,21,3,Life Sciences,1,1086,3,Male,52,2,3,Healthcare Representative,3,Divorced,10800,12600,4,Y,No,17,3,3,80,1,13,3,3,9,6,4,7
25,Yes,Travel_Rarely,475,Human Resources,4,1,Psychology,1,1087,1,Female,35,4,1,HR Specialist,1,Single,4200,23800,0,Y,Yes,10,3,1,80,0,2,1,1,1,0,0,0
51,No,Travel_Frequently,1235,Sales,16,4,Business,1,1088,2,Male,80,2,5,Manager,2,Married,24600,8800,8,Y,No,26,4,2,80,3,28,2,4,21,15,10,17
30,No,Travel_Rarely,665,Research & Development,27,2,Engineering,1,1089,4,Female,48,3,2,Research Scientist,4,Single,7800,18200,2,Y,Yes,14,3,4,80,1,7,4,4,5,3,2,3
43,Yes,Non-Travel,1065,Human Resources,9,3,Psychology,1,1090,3,Male,70,2,4,HR Manager,3,Divorced,14800,11200,7,Y,No,20,3,3,80,2,20,3,4,14,10,6,11
32,No,Travel_Rarely,785,Sales,18,4,Marketing,1,1091,1,Female,56,4,3,Sales Representative,1,Married,8600,15800,3,Y,Yes,15,3,1,80,1,9,1,1,6,4,2,4
39,No,Travel_Frequently,895,Research & Development,25,1,Life Sciences,1,1092,2,Male,63,3,3,Research Scientist,2,Single,11400,13800,5,Y,No,18,3,2,80,3,16,2,3,10,7,5,8
46,Yes,Travel_Rarely,1145,Human Resources,7,2,Psychology,1,1093,4,Female,75,2,4,HR Representative,4,Married,13600,10800,6,Y,Yes,19,3,4,80,2,23,4,4,16,11,7,13
27,No,Non-Travel,595,Sales,22,3,Business,1,1094,3,Male,41,4,2,Sales Representative,3,Divorced,5400,21000,1,Y,No,13,3,3,80,0,4,3,3,2,1,0,1
48,No,Travel_Rarely,1155,Research & Development,13,4,Engineering,1,1095,1,Female,77,3,5,Manufacturing Director,1,Single,19800,9400,8,Y,Yes,23,4,1,80,3,25,1,4,18,13,9,15
35,No,Travel_Frequently,715,Human Resources,24,2,Psychology,1,1096,2,Male,50,2,3,HR Specialist,2,Married,9200,14200,4,Y,No,16,3,2,80,2,12,2,2,8,5,3,6
31,Yes,Travel_Rarely,635,Sales,10,3,Marketing,1,1097,4,Female,45,4,1,Sales Executive,4,Single,6800,19200,2,Y,Yes,14,3,4,80,1,8,4,4,5,3,2,3
44,No,Non-Travel,1025,Research & Development,19,4,Life Sciences,1,1098,3,Male,69,3,4,Healthcare Representative,3,Divorced,13800,11600,5,Y,No,20,3,3,80,2,21,3,3,15,10,7,12
28,No,Travel_Rarely,565,Human Resources,26,1,Psychology,1,1099,1,Female,39,4,2,HR Representative,1,Married,6400,20400,1,Y,Yes,12,3,1,80,0,5,1,1,3,2,1,2
52,Yes,Travel_Frequently,1285,Sales,3,2,Business,1,1100,2,Male,83,2,5,Manager,2,Single,25400,7600,9,Y,No,28,4,2,80,3,29,2,4,22,16,11,18
33,No,Travel_Rarely,675,Research & Development,17,3,Engineering,1,1101,4,Female,49,3,2,Laboratory Technician,4,Married,7400,17000,3,Y,Yes,15,3,4,80,1,10,4,4,7,4,2,5
40,No,Non-Travel,955,Human Resources,14,4,Psychology,1,1102,3,Male,67,2,3,HR Specialist,3,Divorced,12200,12400,5,Y,No,19,3,3,80,2,17,3,3,12,8,5,9
29,Yes,Travel_Rarely,545,Sales,28,1,Marketing,1,1103,1,Female,37,4,1,Sales Representative,1,Single,4800,22800,0,Y,Yes,11,3,1,80,0,6,1,1,4,2,1,2
45,No,Travel_Frequently,1105,Research & Development,6,2,Life Sciences,1,1104,2,Male,73,3,4,Healthcare Representative,2,Married,16200,10400,6,Y,No,22,4,2,80,2,22,2,4,15,11,7,12
34,No,Travel_Rarely,795,Human Resources,20,3,Psychology,1,1105,4,Female,55,4,3,HR Representative,4,Single,9800,14800,4,Y,Yes,16,3,4,80,1,11,4,4,8,5,3,6
27,Yes,Non-Travel,485,Sales,11,2,Business,1,1106,3,Male,38,3,1,Sales Executive,3,Married,5600,20600,1,Y,No,12,3,3,80,0,4,3,3,2,1,0,1
49,No,Travel_Rarely,1195,Research & Development,25,4,Engineering,1,1107,1,Female,78,2,5,Manufacturing Director,1,Divorced,21800,8600,8,Y,Yes,25,4,1,80,3,26,1,4,19,14,9,16
36,No,Travel_Frequently,735,Human Resources,8,1,Psychology,1,1108,2,Male,52,3,2,HR Specialist,2,Single,8400,16200,3,Y,No,17,3,2,80,2,13,2,2,9,6,4,7
31,Yes,Travel_Rarely,615,Sales,23,3,Marketing,1,1109,4,Female,44,4,2,Sales Representative,4,Married,6200,19400,2,Y,Yes,13,3,4,80,1,8,4,4,5,3,2,3
42,No,Non-Travel,985,Research & Development,12,2,Life Sciences,1,1110,3,Male,68,2,4,Research Scientist,3,Divorced,14600,11800,5,Y,No,20,3,3,80,2,19,3,3,13,9,6,10
28,No,Travel_Rarely,555,Human Resources,29,4,Psychology,1,1111,1,Female,36,4,1,HR Representative,1,Single,5400,21800,0,Y,Yes,14,3,1,80,0,5,1,1,3,2,1,2
53,Yes,Travel_Frequently,1325,Sales,2,3,Business,1,1112,2,Male,84,3,5,Sales Director,2,Married,27600,7200,10,Y,No,30,4,2,80,3,30,2,4,23,17,12,19
35,No,Travel_Rarely,715,Research & Development,16,2,Engineering,1,1113,4,Female,50,3,3,Laboratory Technician,4,Single,8800,15600,3,Y,Yes,16,3,4,80,1,12,4,4,8,5,3,6
30,No,Non-Travel,625,Human Resources,21,1,Psychology,1,1114,3,Male,42,4,2,HR Specialist,3,Married,7600,18200,1,Y,No,15,3,3,80,3,7,3,3,4,3,2,2
46,Yes,Travel_Rarely,1135,Sales,7,4,Marketing,1,1115,1,Female,74,2,4,Sales Executive,1,Divorced,18400,9200,7,Y,Yes,23,4,1,80,2,23,1,4,16,11,8,13
33,No,Travel_Frequently,665,Research & Development,18,3,Life Sciences,1,1116,2,Male,47,3,2,Research Scientist,2,Single,9200,14400,4,Y,No,17,3,2,80,2,10,2,2,7,4,3,5
41,No,Travel_Rarely,915,Human Resources,24,2,Psychology,1,1117,4,Female,65,2,3,HR Manager,4,Married,13800,11600,6,Y,Yes,19,3,4,80,2,18,4,4,12,8,5,9
26,Yes,Non-Travel,475,Sales,9,1,Business,1,1118,3,Male,35,4,1,Sales Representative,3,Single,3600,24200,0,Y,No,10,3,3,80,0,3,3,3,2,1,0,1
50,No,Travel_Rarely,1255,Research & Development,27,4,Engineering,1,1119,1,Female,79,3,5,Manufacturing Director,1,Divorced,23400,8200,9,Y,Yes,27,4,1,80,3,27,1,4,20,15,10,17
37,No,Travel_Frequently,785,Human Resources,5,3,Psychology,1,1120,2,Male,56,2,4,HR Representative,2,Married,11600,13200,5,Y,No,18,3,2,80,2,14,2,2,10,7,4,8
32,Yes,Travel_Rarely,595,Sales,22,2,Marketing,1,1121,4,Female,41,4,3,Sales Executive,4,Single,7800,17800,3,Y,Yes,14,3,4,80,1,9,4,4,6,4,2,4
44,No,Non-Travel,1045,Research & Development,13,1,Life Sciences,1,1122,3,Male,71,3,3,Healthcare Representative,3,Married,15200,10400,6,Y,No,21,3,3,80,2,21,3,3,15,10,7,12
29,No,Travel_Rarely,535,Human Resources,26,4,Psychology,1,1123,1,Female,38,4,2,HR Specialist,1,Divorced,6800,19600,1,Y,Yes,13,3,1,80,0,6,1,1,4,2,1,2
48,Yes,Travel_Frequently,1185,Sales,10,2,Business,1,1124,2,Male,76,2,5,Manager,2,Single,22800,8400,8,Y,No,25,4,2,80,3,25,2,4,18,13,9,15
34,No,Travel_Rarely,705,Research & Development,19,3,Engineering,1,1125,4,Female,48,3,2,Laboratory Technician,4,Married,8200,16400,4,Y,Yes,15,3,4,80,1,11,4,4,8,5,3,6
31,No,Non-Travel,645,Human Resources,4,1,Psychology,1,1126,3,Male,43,4,1,HR Representative,3,Single,6400,19200,2,Y,No,16,3,3,80,3,8,3,3,5,3,2,3
43,Yes,Travel_Rarely,975,Sales,17,4,Marketing,1,1127,1,Female,69,3,4,Sales Executive,1,Married,16800,9600,5,Y,Yes,20,3,1,80,2,20,1,1,14,10,6,11
38,No,Travel_Frequently,825,Research & Development,25,2,Life Sciences,1,1128,2,Male,58,2,3,Research Scientist,2,Divorced,11800,12600,4,Y,No,18,3,2,80,2,15,2,2,10,7,5,8
25,No,Travel_Rarely,465,Human Resources,8,3,Psychology,1,1129,4,Female,34,4,2,HR Specialist,4,Single,4600,22600,0,Y,Yes,11,3,4,80,0,2,4,4,1,0,0,0
51,Yes,Non-Travel,1235,Sales,21,1,Business,1,1130,3,Male,81,2,5,Sales Director,3,Married,25800,7800,9,Y,No,28,4,3,80,3,28,3,4,21,16,11,17
35,No,Travel_Rarely,745,Research & Development,14,4,Engineering,1,1131,1,Female,51,3,3,Manufacturing Director,1,Single,10600,13800,3,Y,Yes,17,3,1,80,3,12,1,1,8,5,4,6
28,No,Travel_Frequently,575,Human Resources,28,2,Psychology,1,1132,2,Male,40,4,2,HR Representative,2,Married,7200,18400,1,Y,No,14,3,2,80,0,5,2,2,3,2,1,2
47,Yes,Travel_Rarely,1165,Sales,6,3,Marketing,1,1133,4,Female,75,3,4,Sales Executive,4,Divorced,17600,9800,6,Y,Yes,22,3,4,80,2,24,4,4,17,12,8,14
32,No,Non-Travel,685,Research & Development,20,1,Life Sciences,1,1134,3,Male,46,2,2,Research Scientist,3,Single,7800,17600,2,Y,No,15,3,3,80,1,9,3,3,6,4,2,4
39,No,Travel_Rarely,855,Human Resources,12,4,Psychology,1,1135,1,Female,61,3,3,HR Manager,1,Married,12400,12200,5,Y,Yes,18,3,1,80,2,16,1,1,11,8,5,9
46,Yes,Travel_Frequently,1095,Sales,29,2,Business,1,1136,2,Male,73,2,5,Manager,2,Single,21200,8600,8,Y,No,24,4,2,80,3,23,2,4,16,12,9,13
27,No,Travel_Rarely,515,Research & Development,15,3,Engineering,1,1137,4,Female,37,4,1,Laboratory Technician,4,Married,4800,21600,1,Y,Yes,12,3,4,80,0,4,4,4,2,1,0,1
52,No,Non-Travel,1275,Human Resources,3,1,Psychology,1,1138,3,Male,80,2,4,HR Manager,3,Divorced,19200,9400,9,Y,No,26,4,3,80,2,29,3,4,22,16,10,18
36,Yes,Travel_Rarely,795,Sales,18,4,Marketing,1,1139,1,Female,56,4,3,Sales Representative,1,Single,8600,15800,4,Y,Yes,16,3,1,80,1,13,1,1,9,6,4,7
33,No,Travel_Frequently,715,Research & Development,23,2,Life Sciences,1,1140,2,Male,49,3,2,Healthcare Representative,2,Married,9800,14600,3,Y,No,17,3,2,80,2,10,2,2,7,5,3,5
40,No,Travel_Rarely,935,Human Resources,7,3,Psychology,1,1141,4,Female,66,2,4,HR Representative,4,Single,13600,11800,5,Y,Yes,19,3,4,80,2,17,4,4,12,8,6,10
28,Yes,Non-Travel,545,Sales,24,1,Business,1,1142,3,Male,38,4,1,Sales Executive,3,Married,5800,20800,0,Y,No,13,3,3,80,0,5,3,3,3,2,1,2
49,No,Travel_Rarely,1205,Research & Development,11,4,Engineering,1,1143,1,Female,77,3,5,Manufacturing Director,1,Divorced,22400,8200,8,Y,Yes,26,4,1,80,3,26,1,4,19,14,9,16
34,No,Travel_Frequently,725,Human Resources,26,2,Psychology,1,1144,2,Male,50,2,3,HR Specialist,2,Single,9400,14200,4,Y,No,16,3,2,80,2,11,2,2,8,5,3,6
31,Yes,Travel_Rarely,615,Sales,9,3,Marketing,1,1145,4,Female,43,4,2,Sales Representative,4,Married,6400,19200,2,Y,Yes,14,3,4,80,1,8,4,4,5,3,2,3
45,No,Non-Travel,1055,Research & Development,22,1,Life Sciences,1,1146,3,Male,70,2,4,Research Scientist,3,Divorced,16800,10600,6,Y,No,21,3,3,80,2,22,3,3,15,11,7,12
29,No,Travel_Rarely,525,Human Resources,16,4,Psychology,1,1147,1,Female,36,4,1,HR Representative,1,Single,5600,21200,1,Y,Yes,15,3,1,80,0,6,1,1,4,2,1,2
53,Yes,Travel_Frequently,1345,Sales,5,2,Business,1,1148,2,Male,85,3,5,Sales Director,2,Married,28200,7400,10,Y,No,31,4,2,80,3,30,2,4,23,17,12,19
37,No,Travel_Rarely,765,Research & Development,19,3,Engineering,1,1149,4,Female,54,3,3,Laboratory Technician,4,Single,9200,15400,3,Y,Yes,17,3,4,80,1,14,4,4,10,6,4,8
32,No,Non-Travel,655,Human Resources,25,1,Psychology,1,1150,3,Male,45,4,2,HR Specialist,3,Married,7800,18600,2,Y,No,16,3,3,80,3,9,3,3,6,4,2,4
44,Yes,Travel_Rarely,1015,Sales,8,4,Marketing,1,1151,1,Female,68,2,4,Sales Executive,1,Divorced,18600,9200,7,Y,Yes,23,4,1,80,2,21,1,1,15,11,8,12
30,No,Travel_Frequently,595,Research & Development,21,2,Life Sciences,1,1152,2,Male,41,3,2,Research Scientist,2,Single,8200,16400,1,Y,No,15,3,2,80,2,7,2,2,4,3,1,2
48,No,Travel_Rarely,1225,Human Resources,4,3,Psychology,1,1153,4,Female,78,2,4,HR Manager,4,Married,17800,9600,8,Y,Yes,24,4,4,80,2,25,4,4,18,13,9,15
26,Yes,Non-Travel,455,Sales,17,1,Business,1,1154,3,Male,33,4,1,Sales Representative,3,Single,3400,24800,0,Y,No,9,3,3,80,0,3,3,3,2,1,0,1
41,No,Travel_Rarely,885,Research & Development,27,4,Engineering,1,1155,1,Female,63,3,3,Manufacturing Director,1,Married,14800,11600,5,Y,Yes,20,3,1,80,3,18,1,1,12,9,6,10
35,No,Travel_Frequently,735,Human Resources,13,2,Psychology,1,1156,2,Male,51,2,3,HR Representative,2,Divorced,10200,13400,4,Y,No,17,3,2,80,2,12,2,2,8,5,4,6
29,Yes,Travel_Rarely,545,Sales,28,3,Marketing,1,1157,4,Female,38,4,2,Sales Executive,4,Single,6800,19600,1,Y,Yes,16,3,4,80,1,6,4,4,4,3,2,2
46,No,Non-Travel,1125,Research & Development,10,1,Life Sciences,1,1158,3,Male,72,2,5,Research Director,3,Married,21800,8800,7,Y,No,25,4,3,80,2,23,3,4,16,12,8,13
33,No,Travel_Rarely,675,Human Resources,24,4,Psychology,1,1159,1,Female,47,4,2,HR Specialist,1,Single,8400,16200,3,Y,Yes,15,3,1,80,0,10,1,1,7,4,3,5
38,Yes,Travel_Frequently,825,Sales,6,2,Business,1,1160,2,Male,58,3,4,Sales Executive,2,Married,14600,10800,5,Y,No,19,3,2,80,2,15,2,2,10,7,5,8
52,No,Travel_Rarely,1295,Research & Development,20,3,Engineering,1,1161,4,Female,82,2,5,Manufacturing Director,4,Divorced,25400,7800,9,Y,Yes,28,4,4,80,2,29,4,4,22,16,11,18
27,No,Non-Travel,515,Human Resources,12,1,Psychology,1,1162,3,Male,36,4,1,HR Representative,3,Single,5200,21400,1,Y,No,13,3,3,80,0,4,3,3,2,1,0,1
43,Yes,Travel_Rarely,995,Sales,18,4,Marketing,1,1163,1,Female,69,3,3,Sales Representative,1,Married,11800,12600,6,Y,Yes,21,3,1,80,1,20,1,1,14,10,7,11
31,No,Travel_Frequently,625,Research & Development,29,2,Life Sciences,1,1164,2,Male,43,2,2,Research Scientist,2,Divorced,8600,15800,2,Y,No,16,3,2,80,3,8,2,2,5,3,2,3
47,No,Travel_Rarely,1155,Human Resources,3,3,Psychology,1,1165,4,Female,75,2,4,HR Manager,4,Single,16400,10200,7,Y,Yes,22,4,4,80,2,24,4,4,17,12,8,14
34,Yes,Non-Travel,715,Sales,15,1,Business,1,1166,3,Male,49,4,3,Sales Executive,3,Married,9800,14600,4,Y,No,17,3,3,80,1,11,3,3,8,5,4,6
26,No,Travel_Rarely,465,Research & Development,23,4,Engineering,1,1167,1,Female,34,3,1,Laboratory Technician,1,Single,4200,22400,0,Y,Yes,12,3,1,80,0,3,1,1,2,1,0,1
50,No,Travel_Frequently,1245,Human Resources,7,2,Psychology,1,1168,2,Male,79,2,5,HR Manager,2,Divorced,22600,8600,8,Y,No,27,4,2,80,3,27,2,4,20,15,10,17
36,Yes,Travel_Rarely,785,Sales,21,3,Marketing,1,1169,4,Female,55,3,4,Sales Representative,4,Single,10200,13400,3,Y,Yes,18,3,4,80,1,13,4,4,9,6,4,7
42,No,Non-Travel,925,Research & Development,11,4,Life Sciences,1,1170,3,Male,65,3,3,Healthcare Representative,3,Married,13800,11600,5,Y,No,20,3,3,80,2,19,3,3,13,9,6,10
28,No,Travel_Rarely,535,Human Resources,26,1,Psychology,1,1171,1,Female,37,4,2,HR Representative,1,Divorced,6200,20200,1,Y,Yes,14,3,1,80,0,5,1,1,3,2,1,2
45,Yes,Travel_Frequently,1085,Sales,9,2,Business,1,1172,2,Male,71,2,5,Manager,2,Single,20400,8400,7,Y,No,24,4,2,80,3,22,2,4,15,11,8,12
33,No,Travel_Rarely,695,Research & Development,22,3,Engineering,1,1173,4,Female,48,3,2,Laboratory Technician,4,Married,8400,16200,4,Y,Yes,15,3,4,80,1,10,4,4,7,4,3,5
39,No,Non-Travel,855,Human Resources,16,4,Psychology,1,1174,3,Male,60,2,3,HR Specialist,3,Single,11200,12400,5,Y,No,18,3,3,80,2,16,3,3,11,8,5,9
31,Yes,Travel_Rarely,605,Sales,25,1,Marketing,1,1175,1,Female,42,4,1,Sales Executive,1,Married,7400,18200,2,Y,Yes,16,3,1,80,1,8,1,1,5,3,2,3
54,No,Travel_Frequently,1365,Research & Development,4,2,Life Sciences,1,1176,2,Male,86,3,5,Research Director,2,Divorced,26800,7600,9,Y,No,30,4,2,80,3,31,2,4,24,18,12,20
37,No,Travel_Rarely,795,Human Resources,18,3,Psychology,1,1177,4,Female,56,2,4,HR Representative,4,Single,10600,13800,4,Y,Yes,17,3,4,80,2,14,4,4,10,7,4,8
24,Yes,Non-Travel,425,Sales,8,1,Business,1,1178,3,Male,31,4,1,Sales Representative,3,Single,3200,25200,0,Y,No,8,3,3,80,0,1,3,3,0,0,0,0
48,No,Travel_Rarely,1185,Research & Development,27,4,Engineering,1,1179,1,Female,76,3,4,Manufacturing Director,1,Married,20600,9000,8,Y,Yes,25,4,1,80,3,25,1,4,18,13,9,15
35,No,Travel_Frequently,725,Human Resources,13,2,Psychology,1,1180,2,Male,50,2,3,HR Specialist,2,Divorced,9400,14200,3,Y,No,16,3,2,80,2,12,2,2,8,5,3,6
30,Yes,Travel_Rarely,575,Sales,29,3,Marketing,1,1181,4,Female,40,4,2,Sales Executive,4,Single,7200,18400,1,Y,Yes,15,3,4,80,1,7,4,4,4,3,2,2
43,No,Non-Travel,985,Research & Development,14,1,Life Sciences,1,1182,3,Male,67,2,3,Research Scientist,3,Married,13200,12200,5,Y,No,19,3,3,80,2,20,3,3,14,10,6,11
29,No,Travel_Rarely,515,Human Resources,21,4,Psychology,1,1183,1,Female,36,4,1,HR Representative,1,Single,5800,20600,1,Y,Yes,13,3,1,80,0,6,1,1,4,2,1,2
51,Yes,Travel_Frequently,1255,Sales,5,2,Business,1,1184,2,Male,80,3,5,Sales Director,2,Married,24200,8200,10,Y,No,28,4,2,80,3,28,2,4,21,16,11,17
36,No,Travel_Rarely,745,Research & Development,19,3,Engineering,1,1185,4,Female,52,3,3,Laboratory Technician,4,Divorced,9600,14800,4,Y,Yes,17,3,4,80,1,13,4,4,9,6,4,7
32,No,Non-Travel,635,Human Resources,26,1,Psychology,1,1186,3,Male,44,4,2,HR Specialist,3,Single,7600,18800,2,Y,No,15,3,3,80,3,9,3,3,6,4,2,4
44,Yes,Travel_Rarely,1025,Sales,10,4,Marketing,1,1187,1,Female,69,2,4,Sales Executive,1,Married,17200,9400,6,Y,Yes,22,4,1,80,2,21,1,1,15,11,8,12
28,No,Travel_Frequently,555,Research & Development,23,2,Life Sciences,1,1188,2,Male,38,3,2,Research Scientist,2,Single,7800,17600,1,Y,No,14,3,2,80,2,5,2,2,3,2,1,2
47,No,Travel_Rarely,1165,Human Resources,6,3,Psychology,1,1189,4,Female,74,2,4,HR Manager,4,Married,16800,10600,7,Y,Yes,23,4,4,80,2,24,4,4,17,12,8,14
33,Yes,Non-Travel,685,Sales,17,1,Business,1,1190,3,Male,46,4,3,Sales Representative,3,Divorced,8200,16400,3,Y,No,16,3,3,80,1,10,3,3,7,4,3,5
26,No,Travel_Rarely,445,Research & Development,24,4,Engineering,1,1191,1,Female,33,3,1,Laboratory Technician,1,Single,4000,23600,0,Y,Yes,11,3,1,80,0,3,1,1,2,1,0,1
49,No,Travel_Frequently,1205,Human Resources,11,2,Psychology,1,1192,2,Male,77,2,5,HR Manager,2,Married,21400,8800,8,Y,No,26,4,2,80,3,26,2,4,19,14,9,16
38,Yes,Travel_Rarely,815,Sales,28,3,Marketing,1,1193,4,Female,57,3,4,Sales Executive,4,Single,11600,12800,4,Y,Yes,19,3,4,80,1,15,4,4,11,7,5,9
41,No,Non-Travel,965,Research & Development,2,4,Life Sciences,1,1194,3,Male,66,2,3,Healthcare Representative,3,Married,14200,11200,5,Y,No,20,3,3,80,2,18,3,3,12,9,6,10
34,No,Travel_Rarely,715,Human Resources,15,1,Psychology,1,1195,1,Female,49,4,2,HR Representative,1,Divorced,8600,15800,3,Y,Yes,16,3,1,80,0,11,1,1,8,5,3,6
27,Yes,Travel_Frequently,485,Sales,25,2,Business,1,1196,2,Male,35,4,1,Sales Representative,2,Single,4600,21800,0,Y,No,12,3,2,80,0,4,2,2,2,1,0,1
52,No,Travel_Rarely,1285,Research & Development,9,3,Engineering,1,1197,4,Female,81,2,5,Manufacturing Director,4,Married,24600,8000,9,Y,Yes,29,4,4,80,2,29,4,4,22,16,11,18
35,No,Non-Travel,755,Human Resources,20,4,Psychology,1,1198,3,Male,53,2,3,HR Specialist,3,Single,10400,13200,4,Y,No,17,3,3,80,2,12,3,3,8,5,4,6
30,Yes,Travel_Rarely,595,Sales,12,1,Marketing,1,1199,1,Female,41,4,2,Sales Executive,1,Married,7600,18000,2,Y,Yes,15,3,1,80,1,7,1,1,4,3,2,2
46,No,Travel_Frequently,1135,Research & Development,29,2,Life Sciences,1,1200,2,Male,72,3,4,Research Scientist,2,Divorced,17800,9600,6,Y,No,22,4,2,80,2,23,2,4,16,11,8,13
33,No,Travel_Rarely,675,Human Resources,16,3,Psychology,1,1201,4,Female,47,2,3,HR Representative,4,Single,9200,14400,3,Y,Yes,16,3,4,80,1,10,4,4,7,4,3,5
40,yes,Travel_Rarely,975,Sales,8,4,Marketing,2,1425,2,Male,32,2,1,Sales Executive,2,Married,10000,15000,2,Y,Yes,12,3,4,80,1,29,4,4,22,16,11,18
42,No,Travel_Rarely,1147,Human Resources,10,3,Human Resources,1,1408,3,Female,31,3,4,Manager,1,Married,16799,16616,0,Y,No,14,3,3,80,1,21,5,3,20,7,0,9
52,No,Travel_Rarely,258,Research & Development,8,4,Other,1,1409,3,Female,54,3,1,Laboratory Technician,1,Married,2950,17363,9,Y,No,13,3,3,80,0,12,2,1,5,4,0,4
37,No,Travel_Rarely,1462,Research & Development,11,3,Medical,1,1411,1,Female,94,3,1,Laboratory Technician,3,Single,3629,19106,4,Y,No,18,3,1,80,0,8,6,3,3,2,0,2
35,No,Travel_Frequently,200,Research & Development,18,2,Life Sciences,1,1412,3,Male,60,3,3,Manufacturing Director,4,Single,9362,19944,2,Y,No,11,3,3,80,0,10,2,3,2,2,2,2
25,No,Travel_Rarely,949,Research & Development,1,3,Technical Degree,1,1415,1,Male,81,3,1,Laboratory Technician,4,Married,3229,4910,4,Y,No,11,3,2,80,1,7,2,2,3,2,0,2
26,No,Travel_Rarely,652,Research & Development,7,3,Other,1,1417,3,Male,100,4,1,Laboratory Technician,1,Single,3578,23577,0,Y,No,12,3,4,80,0,8,2,3,7,7,0,7
29,No,Travel_Rarely,332,Human Resources,17,3,Other,1,1419,2,Male,51,2,3,Human Resources,1,Single,7988,9769,1,Y,No,13,3,1,80,0,10,3,2,10,9,0,9
49,Yes,Travel_Frequently,1475,Research & Development,28,2,Life Sciences,1,1420,1,Male,97,2,2,Laboratory Technician,1,Single,4284,22710,3,Y,No,20,4,1,80,0,20,2,3,4,3,1,3
29,Yes,Travel_Frequently,337,Research & Development,14,1,Other,1,1421,3,Female,84,3,3,Healthcare Representative,4,Single,7553,22930,0,Y,Yes,12,3,1,80,0,9,1,3,8,7,7,7
54,No,Travel_Rarely,971,Research & Development,1,3,Medical,1,1422,4,Female,54,3,4,Research Director,4,Single,17328,5652,6,Y,No,19,3,4,80,0,29,3,2,20,7,12,7
58,No,Travel_Rarely,1055,Research & Development,1,3,Medical,1,1423,4,Female,76,3,5,Research Director,1,Married,19701,22456,3,Y,Yes,21,4,3,80,1,32,3,3,9,8,1,5
55,No,Travel_Rarely,1136,Research & Development,1,4,Medical,1,1424,2,Male,81,4,4,Research Director,4,Divorced,14732,12414,2,Y,No,13,3,4,80,2,31,4,4,7,7,0,0
36,No,Travel_Rarely,1174,Sales,3,4,Marketing,1,1425,1,Female,99,3,2,Sales Executive,2,Single,9278,20763,3,Y,Yes,16,3,4,80,0,15,3,3,5,4,0,1
31,Yes,Travel_Frequently,667,Sales,1,4,Life Sciences,1,1427,2,Female,50,1,1,Sales Representative,3,Single,1359,16154,1,Y,No,12,3,2,80,0,1,3,3,1,0,0,0
30,No,Travel_Rarely,855,Sales,7,4,Marketing,1,1428,4,Female,73,3,2,Sales Executive,1,Divorced,4779,12761,7,Y,No,14,3,2,80,2,8,3,3,3,2,0,2
31,No,Travel_Rarely,182,Research & Development,8,5,Life Sciences,1,1430,1,Female,93,3,4,Research Director,2,Single,16422,8847,3,Y,No,11,3,3,80,0,9,3,4,3,2,1,0
34,No,Travel_Frequently,560,Research & Development,1,4,Other,1,1431,4,Male,91,3,1,Research Scientist,1,Divorced,2996,20284,5,Y,No,14,3,3,80,2,10,2,3,4,3,1,3
31,Yes,Travel_Rarely,202,Research & Development,8,3,Life Sciences,1,1433,1,Female,34,2,1,Research Scientist,2,Single,1261,22262,1,Y,No,12,3,3,80,0,1,3,4,1,0,0,0
27,No,Travel_Rarely,1377,Research & Development,11,1,Life Sciences,1,1434,2,Male,91,3,1,Laboratory Technician,1,Married,2099,7679,0,Y,No,14,3,2,80,0,6,3,4,5,0,1,4
36,No,Travel_Rarely,172,Research & Development,4,4,Life Sciences,1,1435,1,Male,37,2,2,Laboratory Technician,4,Single,5810,22604,1,Y,No,16,3,3,80,0,10,2,2,10,4,1,8
36,No,Travel_Rarely,329,Sales,16,4,Marketing,1,1436,3,Female,98,2,2,Sales Executive,1,Married,5647,13494,4,Y,No,13,3,1,80,2,11,3,2,3,2,0,2
47,No,Travel_Rarely,465,Research & Development,1,3,Technical Degree,1,1438,1,Male,74,3,1,Research Scientist,4,Married,3420,10205,7,Y,No,12,3,3,80,1,17,2,2,6,5,1,2
25,Yes,Travel_Rarely,383,Sales,9,2,Life Sciences,1,1439,1,Male,68,2,1,Sales Representative,1,Married,4400,15182,3,Y,No,12,3,1,80,0,6,2,3,3,2,2,2
37,No,Non-Travel,1413,Research & Development,5,2,Technical Degree,1,1440,3,Male,84,4,1,Laboratory Technician,3,Single,3500,25470,0,Y,No,14,3,1,80,0,7,2,1,6,5,1,3
56,No,Travel_Rarely,1255,Research & Development,1,2,Life Sciences,1,1441,1,Female,90,3,1,Research Scientist,1,Married,2066,10494,2,Y,No,22,4,4,80,1,5,3,4,3,2,1,0
47,No,Travel_Rarely,359,Research & Development,2,4,Medical,1,1443,1,Female,82,3,4,Research Director,3,Married,17169,26703,3,Y,No,19,3,2,80,2,26,2,4,20,17,5,6
24,No,Travel_Rarely,1476,Sales,4,1,Medical,1,1445,4,Female,42,3,2,Sales Executive,3,Married,4162,15211,1,Y,Yes,12,3,3,80,2,5,3,3,5,4,0,3
32,No,Travel_Rarely,601,Sales,7,5,Marketing,1,1446,4,Male,97,3,2,Sales Executive,4,Married,9204,23343,4,Y,No,12,3,3,80,1,7,3,2,4,3,0,3
34,No,Travel_Rarely,401,Research & Development,1,3,Life Sciences,1,1447,4,Female,86,2,1,Laboratory Technician,2,Married,3294,3708,5,Y,No,17,3,1,80,1,7,2,2,5,4,0,2
41,No,Travel_Rarely,1283,Research & Development,5,5,Medical,1,1448,2,Male,90,4,1,Research Scientist,3,Married,2127,5561,2,Y,Yes,12,3,1,80,0,7,5,2,4,2,0,3
40,No,Non-Travel,663,Research & Development,9,4,Other,1,1449,3,Male,81,3,2,Laboratory Technician,3,Divorced,3975,23099,3,Y,No,11,3,3,80,2,11,2,4,8,7,0,7
31,No,Travel_Rarely,326,Sales,8,2,Life Sciences,1,1453,1,Male,31,3,3,Sales Executive,4,Divorced,10793,8386,1,Y,No,18,3,1,80,1,13,5,3,13,7,9,9
46,Yes,Travel_Rarely,377,Sales,9,3,Marketing,1,1457,1,Male,52,3,3,Sales Executive,4,Divorced,10096,15986,4,Y,No,11,3,1,80,1,28,1,4,7,7,4,3
39,Yes,Non-Travel,592,Research & Development,2,3,Life Sciences,1,1458,1,Female,54,2,1,Laboratory Technician,1,Single,3646,17181,2,Y,Yes,23,4,2,80,0,11,2,4,1,0,0,0
31,Yes,Travel_Frequently,1445,Research & Development,1,5,Life Sciences,1,1459,3,Female,100,4,3,Manufacturing Director,2,Single,7446,8931,1,Y,No,11,3,1,80,0,10,2,3,10,8,4,7
45,No,Travel_Rarely,1038,Research & Development,20,3,Medical,1,1460,2,Male,95,1,3,Healthcare Representative,1,Divorced,10851,19863,2,Y,Yes,18,3,2,80,1,24,2,3,7,7,0,7
31,No,Travel_Rarely,1398,Human Resources,8,2,Medical,1,1461,4,Female,96,4,1,Human Resources,2,Single,2109,24609,9,Y,No,18,3,4,80,0,8,3,3,3,2,0,2
31,Yes,Travel_Frequently,523,Research & Development,2,3,Life Sciences,1,1464,2,Male,94,3,1,Laboratory Technician,4,Married,3722,21081,6,Y,Yes,13,3,3,80,1,7,2,1,2,2,2,2
45,No,Travel_Rarely,1448,Research & Development,29,3,Technical Degree,1,1465,2,Male,55,3,3,Manufacturing Director,4,Married,9380,14720,4,Y,Yes,18,3,4,80,2,10,4,4,3,1,1,2
48,No,Travel_Rarely,1221,Sales,7,3,Marketing,1,1466,3,Male,96,3,2,Sales Executive,1,Divorced,5486,24795,4,Y,No,11,3,1,80,3,15,3,3,2,2,2,2
34,Yes,Travel_Rarely,1107,Human Resources,9,4,Technical Degree,1,1467,1,Female,52,3,1,Human Resources,3,Married,2742,3072,1,Y,No,15,3,4,80,0,2,0,3,2,2,2,2
40,No,Non-Travel,218,Research & Development,8,1,Medical,1,1468,4,Male,55,2,3,Research Director,2,Divorced,13757,25178,2,Y,No,11,3,3,80,1,16,5,3,9,8,4,8
28,No,Travel_Rarely,866,Sales,5,3,Medical,1,1469,4,Male,84,3,2,Sales Executive,1,Single,8463,23490,0,Y,No,18,3,4,80,0,6,4,3,5,4,1,3
44,No,Non-Travel,981,Research & Development,5,3,Life Sciences,1,1471,3,Male,90,2,1,Laboratory Technician,3,Single,3162,7973,3,Y,No,14,3,4,80,0,7,5,3,5,2,0,3
53,No,Travel_Rarely,447,Research & Development,2,3,Medical,1,1472,4,Male,39,4,4,Research Director,2,Single,16598,19764,4,Y,No,12,3,2,80,0,35,2,2,9,8,8,8
49,No,Travel_Rarely,1495,Research & Development,5,4,Technical Degree,1,1473,1,Male,96,3,2,Healthcare Representative,3,Married,6651,21534,2,Y,No,14,3,2,80,1,20,0,2,3,2,1,2
40,No,Travel_Rarely,896,Research & Development,2,3,Medical,1,1474,3,Male,68,3,1,Research Scientist,3,Divorced,2345,8045,2,Y,No,14,3,3,80,1,8,3,4,3,1,1,2
44,No,Travel_Rarely,1467,Research & Development,20,3,Life Sciences,1,1475,4,Male,49,3,1,Research Scientist,2,Single,3420,21158,1,Y,No,13,3,3,80,0,6,3,2,5,2,1,3
33,No,Travel_Frequently,430,Sales,7,3,Medical,1,1477,4,Male,54,3,2,Sales Executive,1,Married,4373,17456,0,Y,No,14,3,1,80,2,5,2,3,4,3,0,3
34,No,Travel_Rarely,1326,Sales,3,3,Other,1,1478,4,Male,81,1,2,Sales Executive,1,Single,4759,15891,3,Y,No,18,3,4,80,0,15,2,3,13,9,3,12
30,No,Travel_Rarely,1358,Sales,16,1,Life Sciences,1,1479,4,Male,96,3,2,Sales Executive,3,Married,5301,2939,8,Y,No,15,3,3,80,2,4,2,2,2,1,2,2
42,No,Travel_Frequently,748,Research & Development,9,2,Medical,1,1480,1,Female,74,3,1,Laboratory Technician,4,Single,3673,16458,1,Y,No,13,3,3,80,0,12,3,3,12,9,5,8
44,No,Travel_Frequently,383,Sales,1,5,Marketing,1,1481,1,Female,79,3,2,Sales Executive,3,Married,4768,9282,7,Y,No,12,3,3,80,1,11,4,2,1,0,0,0
30,No,Non-Travel,990,Research & Development,7,3,Technical Degree,1,1482,3,Male,64,3,1,Research Scientist,3,Divorced,1274,7152,1,Y,No,13,3,2,80,2,1,2,2,1,0,0,0
57,No,Travel_Rarely,405,Research & Development,1,2,Life Sciences,1,1483,2,Male,93,4,2,Research Scientist,3,Married,4900,2721,0,Y,No,24,4,1,80,1,13,2,2,12,9,2,8
49,No,Travel_Rarely,1490,Research & Development,7,4,Life Sciences,1,1484,3,Male,35,3,3,Healthcare Representative,2,Divorced,10466,20948,3,Y,No,14,3,2,80,2,29,3,3,8,7,0,7
34,No,Travel_Frequently,829,Research & Development,15,3,Medical,1,1485,2,Male,71,3,4,Research Director,1,Divorced,17007,11929,7,Y,No,14,3,4,80,2,16,3,2,14,8,6,9
28,Yes,Travel_Frequently,1496,Sales,1,3,Technical Degree,1,1486,1,Male,92,3,1,Sales Representative,3,Married,2909,15747,3,Y,No,15,3,4,80,1,5,3,4,3,2,1,2
29,Yes,Travel_Frequently,115,Sales,13,3,Technical Degree,1,1487,1,Female,51,3,2,Sales Executive,2,Single,5765,17485,5,Y,No,11,3,1,80,0,7,4,1,5,3,0,0
34,Yes,Travel_Rarely,790,Sales,24,4,Medical,1,1489,1,Female,40,2,2,Sales Executive,2,Single,4599,7815,0,Y,Yes,23,4,3,80,0,16,2,4,15,9,10,10
35,No,Travel_Rarely,660,Sales,7,1,Life Sciences,1,1492,4,Male,76,3,1,Sales Representative,3,Married,2404,16192,1,Y,No,13,3,1,80,1,1,3,3,1,0,0,0
24,Yes,Travel_Frequently,381,Research & Development,9,3,Medical,1,1494,2,Male,89,3,1,Laboratory Technician,1,Single,3172,16998,2,Y,Yes,11,3,3,80,0,4,2,2,0,0,0,0
24,No,Non-Travel,830,Sales,13,2,Life Sciences,1,1495,4,Female,78,3,1,Sales Representative,2,Married,2033,7103,1,Y,No,13,3,3,80,1,1,2,3,1,0,0,0
44,No,Travel_Frequently,1193,Research & Development,2,1,Medical,1,1496,2,Male,86,3,3,Manufacturing Director,3,Single,10209,19719,5,Y,Yes,18,3,2,80,0,16,2,2,2,2,2,2
29,No,Travel_Rarely,1246,Sales,19,3,Life Sciences,1,1497,3,Male,77,2,2,Sales Executive,3,Divorced,8620,23757,1,Y,No,14,3,3,80,2,10,3,3,10,7,0,4
30,No,Travel_Rarely,330,Human Resources,1,3,Life Sciences,1,1499,3,Male,46,3,1,Human Resources,3,Divorced,2064,15428,0,Y,No,21,4,1,80,1,6,3,4,5,3,1,3
55,No,Travel_Rarely,1229,Research & Development,4,4,Life Sciences,1,1501,4,Male,30,3,2,Healthcare Representative,3,Married,4035,16143,0,Y,Yes,16,3,2,80,0,4,2,3,3,2,1,2
33,No,Travel_Rarely,1099,Research & Development,4,4,Medical,1,1502,1,Female,82,2,1,Laboratory Technician,2,Married,3838,8192,8,Y,No,11,3,4,80,0,8,5,3,5,4,0,2
47,No,Travel_Rarely,571,Sales,14,3,Medical,1,1503,3,Female,78,3,2,Sales Executive,3,Married,4591,24200,3,Y,Yes,17,3,3,80,1,11,4,2,5,4,1,2
28,Yes,Travel_Frequently,289,Research & Development,2,2,Medical,1,1504,3,Male,38,2,1,Laboratory Technician,1,Single,2561,5355,7,Y,No,11,3,3,80,0,8,2,2,0,0,0,0
28,No,Travel_Rarely,1423,Research & Development,1,3,Life Sciences,1,1506,1,Male,72,2,1,Research Scientist,3,Divorced,1563,12530,1,Y,No,14,3,4,80,1,1,2,1,1,0,0,0
28,No,Travel_Frequently,467,Sales,7,3,Life Sciences,1,1507,3,Male,55,3,2,Sales Executive,1,Single,4898,11827,0,Y,No,14,3,4,80,0,5,5,3,4,2,1,3
49,No,Travel_Rarely,271,Research & Development,3,2,Medical,1,1509,3,Female,43,2,2,Laboratory Technician,1,Married,4789,23070,4,Y,No,25,4,1,80,1,10,3,3,3,2,1,2
29,No,Travel_Frequently,410,Research & Development,2,1,Life Sciences,1,1513,4,Female,97,3,1,Laboratory Technician,2,Married,3180,4668,0,Y,No,13,3,3,80,3,4,3,3,3,2,0,2
28,No,Travel_Rarely,1083,Research & Development,29,1,Life Sciences,1,1514,3,Male,96,1,2,Manufacturing Director,2,Married,6549,3173,1,Y,No,14,3,2,80,2,8,2,2,8,6,1,7
33,No,Travel_Rarely,516,Research & Development,8,5,Life Sciences,1,1515,4,Male,69,3,2,Healthcare Representative,3,Single,6388,22049,2,Y,Yes,17,3,1,80,0,14,6,3,0,0,0,0
32,No,Travel_Rarely,495,Research & Development,10,3,Medical,1,1516,3,Male,64,3,3,Manager,4,Single,11244,21072,2,Y,No,25,4,2,80,0,10,5,4,5,2,0,0
54,No,Travel_Frequently,1050,Research & Development,11,4,Medical,1,1520,2,Female,87,3,4,Manager,4,Divorced,16032,24456,3,Y,No,20,4,1,80,1,26,2,3,14,9,1,12
29,Yes,Travel_Rarely,224,Research & Development,1,4,Technical Degree,1,1522,1,Male,100,2,1,Research Scientist,1,Single,2362,7568,6,Y,No,13,3,3,80,0,11,2,1,9,7,0,7
44,No,Travel_Rarely,136,Research & Development,28,3,Life Sciences,1,1523,4,Male,32,3,4,Research Director,1,Married,16328,22074,3,Y,No,13,3,3,80,1,24,1,4,20,6,14,17
39,No,Travel_Rarely,1089,Research & Development,6,3,Life Sciences,1,1525,2,Female,32,3,3,Manufacturing Director,2,Single,8376,9150,4,Y,No,18,3,4,80,0,9,3,3,2,0,2,2
46,No,Travel_Rarely,228,Sales,3,3,Life Sciences,1,1527,3,Female,51,3,4,Manager,2,Married,16606,11380,8,Y,No,12,3,4,80,1,23,2,4,13,12,5,1
35,No,Travel_Rarely,1029,Research & Development,16,3,Life Sciences,1,1529,4,Female,91,2,3,Healthcare Representative,2,Single,8606,21195,1,Y,No,19,3,4,80,0,11,3,1,11,8,3,3
23,No,Travel_Rarely,507,Research & Development,20,1,Life Sciences,1,1533,1,Male,97,3,2,Laboratory Technician,3,Single,2272,24812,0,Y,No,14,3,2,80,0,5,2,3,4,3,1,2
40,Yes,Travel_Rarely,676,Research & Development,9,4,Life Sciences,1,1534,4,Male,86,3,1,Laboratory Technician,1,Single,2018,21831,3,Y,No,14,3,2,80,0,15,3,1,5,4,1,0
34,No,Travel_Rarely,971,Sales,1,3,Technical Degree,1,1535,4,Male,64,2,3,Sales Executive,3,Married,7083,12288,1,Y,Yes,14,3,4,80,0,10,3,3,10,9,8,6
31,Yes,Travel_Frequently,561,Research & Development,3,3,Life Sciences,1,1537,4,Female,33,3,1,Research Scientist,3,Single,4084,4156,1,Y,No,12,3,1,80,0,7,2,1,7,2,7,7
50,No,Travel_Frequently,333,Research & Development,22,5,Medical,1,1539,3,Male,88,1,4,Research Director,4,Single,14411,24450,1,Y,Yes,13,3,4,80,0,32,2,3,32,6,13,9
34,No,Travel_Rarely,1440,Sales,7,2,Technical Degree,1,1541,2,Male,55,3,1,Sales Representative,3,Married,2308,4944,0,Y,Yes,25,4,2,80,1,12,4,3,11,10,5,7
42,No,Travel_Rarely,1210,Research & Development,2,3,Medical,1,1542,3,Male,68,2,1,Laboratory Technician,2,Married,4841,24052,4,Y,No,14,3,2,80,1,4,3,3,1,0,0,0
37,No,Travel_Rarely,674,Research & Development,13,3,Medical,1,1543,1,Male,47,3,2,Research Scientist,4,Married,4285,3031,1,Y,No,17,3,1,80,0,10,2,3,10,8,3,7
29,No,Travel_Rarely,441,Research & Development,8,1,Other,1,1544,3,Female,39,1,2,Healthcare Representative,1,Married,9715,7288,3,Y,No,13,3,3,80,1,9,3,3,7,7,0,7
33,No,Travel_Rarely,575,Research & Development,25,3,Life Sciences,1,1545,4,Male,44,2,2,Manufacturing Director,2,Single,4320,24152,1,Y,No,13,3,4,80,0,5,2,3,5,3,0,2
45,No,Travel_Rarely,950,Research & Development,28,3,Technical Degree,1,1546,4,Male,97,3,1,Research Scientist,4,Married,2132,4585,4,Y,No,20,4,4,80,1,8,3,3,5,4,0,3
42,No,Travel_Frequently,288,Research & Development,2,3,Life Sciences,1,1547,4,Male,40,3,3,Healthcare Representative,4,Married,10124,18611,2,Y,Yes,14,3,3,80,1,24,3,1,20,8,13,9
40,No,Travel_Rarely,1342,Sales,9,2,Medical,1,1548,1,Male,47,3,2,Sales Executive,1,Married,5473,19345,0,Y,No,12,3,4,80,0,9,5,4,8,4,7,1
33,No,Travel_Rarely,589,Research & Development,28,4,Life Sciences,1,1549,2,Male,79,3,2,Laboratory Technician,3,Married,5207,22949,1,Y,Yes,12,3,2,80,1,15,3,3,15,14,5,7
40,No,Travel_Rarely,898,Human Resources,6,2,Medical,1,1550,3,Male,38,3,4,Manager,4,Single,16437,17381,1,Y,Yes,21,4,4,80,0,21,2,3,21,7,7,7
24,No,Travel_Rarely,350,Research & Development,21,2,Technical Degree,1,1551,3,Male,57,2,1,Laboratory Technician,1,Divorced,2296,10036,0,Y,No,14,3,2,80,3,2,3,3,1,1,0,0
38,Yes,Travel_Frequently,892,Sales,12,2,Marketing,1,2001,2,Male,67,2,2,Sales Executive,3,Single,6847,18934,3,Y,Yes,16,3,2,80,1,14,4,2,8,5,2,3
29,No,Non-Travel,1234,Research & Development,5,3,Life Sciences,1,2002,4,Female,45,4,1,Research Scientist,2,Married,3892,22456,1,Y,No,12,4,4,80,0,8,3,3,4,3,1,2
45,No,Travel_Rarely,567,Human Resources,18,4,Human Resources,1,2003,1,Male,89,1,3,Manager,4,Divorced,14567,15678,5,Y,Yes,18,3,1,80,2,22,2,4,15,10,5,8
33,Yes,Travel_Frequently,789,Sales,3,3,Marketing,1,2004,3,Female,72,3,2,Sales Executive,1,Single,5234,19876,2,Y,No,14,3,3,80,0,11,5,2,7,4,1,4
26,No,Travel_Rarely,1456,Research & Development,9,2,Technical Degree,1,2005,2,Male,56,2,1,Laboratory Technician,3,Married,2987,12345,0,Y,Yes,11,3,2,80,1,5,2,3,3,2,0,1
41,No,Non-Travel,923,Sales,22,4,Life Sciences,1,2006,4,Female,91,4,4,Manager,2,Married,16234,23567,4,Y,No,20,4,4,80,3,19,1,4,12,8,6,7
27,Yes,Travel_Frequently,445,Research & Development,7,1,Medical,1,2007,1,Male,38,1,1,Research Scientist,1,Single,2145,8976,1,Y,Yes,13,3,1,80,0,6,3,1,2,1,0,1
52,No,Travel_Rarely,1178,Human Resources,14,5,Human Resources,1,2008,3,Female,83,3,5,Manager,3,Divorced,18976,26789,6,Y,No,22,4,3,80,2,28,2,5,20,12,8,10
34,No,Travel_Frequently,634,Sales,11,3,Marketing,1,2009,2,Male,76,2,2,Sales Executive,4,Single,7456,17234,3,Y,Yes,15,3,2,80,1,12,4,3,8,6,2,5
39,Yes,Travel_Rarely,1089,Research & Development,1,4,Medical,1,2010,4,Female,52,4,3,Healthcare Representative,2,Married,9876,21456,2,Y,No,17,3,4,80,0,16,3,3,11,9,3,6
28,No,Non-Travel,767,Research & Development,25,2,Life Sciences,1,2011,1,Male,64,1,1,Laboratory Technician,1,Single,3456,14567,0,Y,No,12,3,1,80,0,7,2,2,5,3,1,2
46,No,Travel_Rarely,1234,Sales,6,3,Life Sciences,1,2012,3,Female,87,3,3,Sales Executive,4,Married,11234,19876,5,Y,Yes,19,3,3,80,1,23,1,4,16,11,7,9
31,Yes,Travel_Frequently,589,Research & Development,19,3,Technical Degree,1,2013,2,Male,41,2,2,Manufacturing Director,3,Single,6789,15432,1,Y,No,14,3,2,80,0,9,4,2,6,4,2,3
37,No,Travel_Rarely,923,Human Resources,8,4,Other,1,2014,4,Female,79,4,2,Human Resources,1,Divorced,5678,22134,3,Y,Yes,16,3,4,80,1,14,3,2,10,7,3,5
25,No,Non-Travel,445,Research & Development,13,1,Medical,1,2015,1,Male,33,1,1,Research Scientist,2,Single,2890,9876,0,Y,No,11,3,1,80,0,4,1,1,2,1,0,0
43,No,Travel_Frequently,1156,Sales,2,5,Marketing,1,2016,3,Female,95,3,4,Manager,3,Married,15678,24567,4,Y,No,21,4,3,80,2,20,2,4,13,10,5,8
29,Yes,Travel_Rarely,678,Research & Development,17,2,Life Sciences,1,2017,2,Male,58,2,1,Laboratory Technician,4,Single,3234,13456,1,Y,Yes,13,3,2,80,0,8,3,1,4,3,1,2
48,No,Travel_Rarely,1089,Human Resources,4,4,Human Resources,1,2018,4,Female,82,4,3,Manager,2,Married,13567,21234,5,Y,No,18,3,4,80,1,25,2,3,18,14,9,11
35,No,Non-Travel,734,Sales,21,3,Life Sciences,1,2019,1,Male,67,1,2,Sales Executive,1,Divorced,6123,18765,2,Y,Yes,15,3,1,80,0,13,4,2,9,6,3,4
30,Yes,Travel_Frequently,456,Research & Development,10,3,Medical,1,2020,3,Female,44,3,1,Research Scientist,3,Single,4567,12890,1,Y,No,12,3,3,80,0,9,2,1,5,3,1,2
42,No,Travel_Rarely,891,Sales,15,4,Marketing,1,2021,2,Male,78,2,3,Sales Executive,4,Married,10456,20123,4,Y,Yes,17,3,2,80,1,19,1,3,12,9,4,7
26,No,Non-Travel,567,Research & Development,6,2,Technical Degree,1,2022,4,Female,39,4,1,Laboratory Technician,2,Single,3123,11456,0,Y,No,11,4,4,80,0,5,3,1,3,2,0,1
51,No,Travel_Rarely,1234,Human Resources,28,5,Other,1,2023,1,Male,91,1,5,Manager,1,Divorced,17890,25678,6,Y,No,23,4,1,80,3,27,1,5,19,15,10,12
33,Yes,Travel_Frequently,678,Sales,3,3,Life Sciences,1,2024,3,Female,62,3,2,Sales Executive,3,Single,7234,16789,2,Y,Yes,14,3,3,80,0,11,4,2,7,5,2,3
38,No,Travel_Rarely,923,Research & Development,12,4,Medical,1,2025,2,Male,75,2,3,Healthcare Representative,4,Married,8901,19234,3,Y,No,16,3,2,80,1,15,2,3,10,8,4,6
27,No,Non-Travel,445,Research & Development,23,1,Life Sciences,1,2026,4,Female,48,4,1,Research Scientist,1,Single,2678,10234,0,Y,Yes,12,4,4,80,0,6,2,1,4,2,1,1
44,No,Travel_Frequently,1167,Sales,9,4,Marketing,1,2027,1,Male,86,1,4,Manager,2,Married,14234,22567,5,Y,No,20,4,1,80,2,21,1,4,15,11,6,9
31,Yes,Travel_Rarely,589,Research & Development,16,2,Technical Degree,1,2028,3,Female,53,3,2,Manufacturing Director,3,Single,5890,14678,1,Y,No,13,3,3,80,0,9,3,2,6,4,2,3
36,No,Travel_Rarely,812,Human Resources,5,3,Human Resources,1,2029,2,Male,71,2,2,Human Resources,4,Divorced,6456,17890,3,Y,Yes,15,3,2,80,1,13,3,2,9,7,3,5
49,No,Non-Travel,1234,Sales,18,5,Life Sciences,1,2030,4,Female,94,4,3,Sales Executive,1,Married,12678,24123,4,Y,No,19,3,4,80,2,26,2,3,17,13,8,10
24,Yes,Travel_Frequently,456,Research & Development,7,1,Medical,1,2031,1,Male,37,1,1,Laboratory Technician,2,Single,2345,8901,0,Y,Yes,11,3,1,80,0,3,2,1,1,0,0,0
47,No,Travel_Rarely,789,Human Resources,22,4,Other,1,2032,3,Female,88,3,4,Manager,3,Divorced,16123,23456,5,Y,No,21,4,3,80,1,24,2,4,16,12,7,9
32,No,Travel_Frequently,634,Sales,11,3,Marketing,1,2033,2,Male,65,2,2,Sales Executive,4,Single,7890,18234,2,Y,Yes,14,3,2,80,0,10,4,2,7,5,2,4
29,Yes,Non-Travel,567,Research & Development,4,2,Life Sciences,1,2034,4,Female,42,4,1,Research Scientist,1,Married,3678,12567,1,Y,No,12,4,4,80,0,8,1,1,4,3,1,2
40,No,Travel_Rarely,923,Sales,19,4,Life Sciences,1,2035,1,Male,77,1,3,Sales Executive,2,Divorced,9234,20456,3,Y,Yes,17,3,1,80,1,17,2,3,11,8,4,6
28,No,Travel_Frequently,445,Research & Development,8,3,Technical Degree,1,2036,3,Female,54,3,2,Manufacturing Director,3,Single,5456,15123,1,Y,No,13,3,3,80,0,7,3,2,5,3,1,2
45,No,Non-Travel,1089,Human Resources,25,5,Human Resources,1,2037,2,Male,81,2,5,Manager,4,Married,15890,22678,6,Y,No,22,4,2,80,3,22,1,5,17,13,8,10
33,Yes,Travel_Rarely,678,Research & Development,1,3,Medical,1,2038,4,Female,49,4,1,Research Scientist,1,Single,3890,11678,0,Y,Yes,12,4,4,80,0,11,2,1,6,4,2,3
37,No,Travel_Frequently,812,Sales,14,4,Marketing,1,2039,1,Male,73,1,2,Sales Executive,3,Married,8123,19567,3,Y,No,15,3,1,80,1,14,3,2,9,7,3,5
26,No,Travel_Rarely,567,Research & Development,3,2,Life Sciences,1,2040,3,Female,46,3,1,Laboratory Technician,2,Single,2789,10890,0,Y,Yes,11,3,3,80,0,5,2,1,3,2,0,1
52,No,Non-Travel,1234,Human Resources,27,5,Other,1,2041,2,Male,89,2,4,Manager,4,Divorced,17234,26123,5,Y,No,24,4,2,80,2,29,2,4,21,16,11,13
34,Yes,Travel_Frequently,689,Sales,9,3,Life Sciences,1,2042,4,Female,61,4,2,Sales Executive,1,Single,6789,17456,2,Y,Yes,14,4,4,80,0,12,4,2,8,5,2,4
41,No,Travel_Rarely,923,Research & Development,16,4,Medical,1,2043,1,Male,78,1,3,Healthcare Representative,3,Married,9567,21234,4,Y,No,18,3,1,80,1,18,2,3,12,9,5,7
30,No,Travel_Frequently,456,Research & Development,6,2,Technical Degree,1,2044,3,Female,43,3,1,Research Scientist,2,Single,3456,12789,1,Y,No,12,3,3,80,0,9,3,1,5,3,1,2
48,No,Non-Travel,1167,Sales,21,4,Marketing,1,2045,2,Male,85,2,4,Manager,4,Divorced,13456,23890,5,Y,Yes,20,4,2,80,2,25,1,4,18,14,9,11
25,Yes,Travel_Rarely,589,Research & Development,12,1,Life Sciences,1,2046,4,Female,38,4,1,Laboratory Technician,1,Single,2567,9123,0,Y,No,11,4,4,80,0,4,2,1,2,1,0,0
43,No,Travel_Frequently,812,Human Resources,5,5,Human Resources,1,2047,1,Male,92,1,3,Manager,2,Married,14789,24567,4,Y,No,19,4,1,80,1,20,2,3,14,10,6,8
35,No,Travel_Rarely,634,Sales,18,3,Life Sciences,1,2048,3,Female,68,3,2,Sales Executive,3,Single,7123,18234,2,Y,Yes,15,3,3,80,0,13,3,2,8,6,3,4
28,Yes,Non-Travel,567,Research & Development,2,2,Medical,1,2049,2,Male,45,2,1,Research Scientist,4,Married,3234,11567,1,Y,No,12,3,2,80,0,7,1,1,4,3,1,2
39,No,Travel_Rarely,923,Sales,15,4,Marketing,1,2050,4,Female,76,4,3,Sales Executive,1,Divorced,8890,20123,3,Y,Yes,16,3,4,80,1,16,2,3,10,8,4,6
27,No,Travel_Frequently,445,Research & Development,8,3,Technical Degree,1,2051,1,Male,52,1,2,Manufacturing Director,2,Single,5123,14890,1,Y,No,13,3,1,80,0,6,3,2,4,2,1,2
46,No,Non-Travel,1089,Human Resources,23,5,Other,1,2052,3,Female,87,3,4,Manager,3,Married,16567,25234,5,Y,No,21,4,3,80,2,23,1,4,16,12,7,9
32,Yes,Travel_Rarely,678,Research & Development,11,3,Life Sciences,1,2053,2,Male,59,2,1,Research Scientist,4,Single,4567,13678,0,Y,Yes,13,3,2,80,0,10,2,1,6,4,2,3
38,No,Travel_Frequently,812,Sales,4,4,Marketing,1,2054,4,Female,74,4,2,Sales Executive,2,Married,7456,19567,3,Y,No,15,3,4,80,1,15,3,2,9,7,3,5
29,No,Travel_Rarely,567,Research & Development,19,2,Medical,1,2055,1,Male,41,1,1,Laboratory Technician,1,Single,2890,10456,0,Y,Yes,12,3,1,80,0,8,2,1,4,3,1,2
44,No,Non-Travel,1234,Human Resources,7,5,Human Resources,1,2056,3,Female,83,3,5,Manager,3,Divorced,15234,23789,4,Y,No,20,4,3,80,1,21,2,5,15,11,6,8
31,Yes,Travel_Frequently,634,Sales,26,3,Life Sciences,1,2057,2,Male,66,2,2,Sales Executive,4,Single,6234,16890,2,Y,Yes,14,3,2,80,0,9,4,2,6,4,2,3
36,No,Travel_Rarely,789,Research & Development,13,4,Technical Degree,1,2058,4,Female,57,4,3,Healthcare Representative,1,Married,8123,18567,3,Y,No,16,3,4,80,1,13,2,3,8,6,3,4
24,No,Travel_Frequently,456,Research & Development,1,1,Life Sciences,1,2059,1,Male,34,1,1,Research Scientist,2,Single,2345,9234,0,Y,No,11,3,1,80,0,3,1,1,1,0,0,0
50,No,Non-Travel,1167,Sales,20,5,Marketing,1,2060,3,Female,91,3,4,Manager,4,Married,14567,22456,5,Y,Yes,22,4,3,80,2,27,1,4,19,15,10,12
33,Yes,Travel_Rarely,589,Research & Development,6,3,Medical,1,2061,2,Male,48,2,1,Laboratory Technician,3,Single,3567,12234,1,Y,No,12,3,2,80,0,11,3,1,6,4,2,3
40,No,Travel_Frequently,812,Human Resources,17,4,Other,1,2062,4,Female,75,4,2,Human Resources,2,Divorced,6789,17123,3,Y,Yes,17,3,4,80,1,17,3,2,11,8,4,6
28,No,Travel_Rarely,567,Research & Development,3,2,Life Sciences,1,2063,1,Male,42,1,1,Research Scientist,1,Married,2789,10567,0,Y,No,12,3,1,80,0,7,2,1,4,3,1,2
47,No,Non-Travel,1089,Sales,24,4,Marketing,1,2064,3,Female,86,3,3,Sales Executive,4,Single,12234,21890,4,Y,No,19,3,3,80,1,24,2,3,17,13,8,10
34,Yes,Travel_Frequently,678,Research & Development,10,3,Technical Degree,1,2065,2,Male,53,2,2,Manufacturing Director,2,Divorced,5890,15456,2,Y,Yes,14,3,2,80,0,12,4,2,8,5,2,4
26,No,Travel_Rarely,445,Research & Development,29,1,Medical,1,2066,4,Female,39,4,1,Laboratory Technician,3,Single,2456,9890,0,Y,No,11,4,4,80,0,5,2,1,3,2,0,1
42,No,Travel_Frequently,923,Human Resources,14,5,Human Resources,1,2067,1,Male,79,1,4,Manager,1,Married,15678,24234,4,Y,Yes,18,4,1,80,2,19,2,4,13,10,5,8
37,No,Non-Travel,634,Sales,2,4,Life Sciences,1,2068,3,Female,67,3,2,Sales Executive,3,Single,7890,18567,2,Y,No,15,3,3,80,0,14,3,2,9,7,3,5
31,Yes,Travel_Rarely,789,Research & Development,18,3,Life Sciences,1,2069,2,Male,54,2,1,Research Scientist,4,Married,4123,13890,1,Y,No,13,3,2,80,0,9,2,1,5,3,1,2
48,No,Travel_Frequently,1167,Sales,5,5,Marketing,1,2070,4,Female,88,4,3,Manager,2,Divorced,13890,23567,5,Y,Yes,21,4,4,80,2,25,1,3,18,14,9,11
25,No,Travel_Rarely,456,Research & Development,22,2,Technical Degree,1,2071,1,Male,37,1,1,Laboratory Technician,1,Single,2567,10123,0,Y,No,11,3,1,80,0,4,2,1,2,1,0,0
45,No,Non-Travel,1089,Human Resources,9,4,Other,1,2072,3,Female,82,3,5,Manager,4,Married,16234,25890,6,Y,No,20,4,3,80,1,22,2,5,16,12,7,9
32,Yes,Travel_Frequently,678,Sales,15,3,Life Sciences,1,2073,2,Male,61,2,2,Sales Executive,3,Single,6567,17456,2,Y,Yes,14,3,2,80,0,10,4,2,7,5,2,4
29,No,Travel_Rarely,567,Research & Development,1,2,Medical,1,2074,4,Female,44,4,1,Research Scientist,2,Married,3456,12678,1,Y,No,12,4,4,80,0,8,1,1,4,3,1,2
38,No,Travel_Frequently,812,Sales,28,4,Marketing,1,2075,1,Male,73,1,3,Sales Executive,4,Divorced,8234,19890,3,Y,Yes,16,3,1,80,1,15,2,3,10,8,4,6
27,No,Non-Travel,445,Research & Development,11,3,Life Sciences,1,2076,3,Female,50,3,2,Manufacturing Director,1,Single,4890,14567,1,Y,No,13,3,3,80,0,6,3,2,4,2,1,2
44,No,Travel_Rarely,1234,Human Resources,4,5,Human Resources,1,2077,2,Male,85,2,4,Manager,3,Married,15567,24123,5,Y,No,19,4,2,80,2,21,1,4,15,11,6,8
33,Yes,Travel_Frequently,634,Research & Development,21,3,Technical Degree,1,2078,4,Female,58,4,1,Research Scientist,2,Single,4234,13456,0,Y,Yes,13,4,4,80,0,11,2,1,6,4,2,3
41,No,Travel_Rarely,789,Sales,7,4,Life Sciences,1,2079,1,Male,76,1,3,Sales Executive,4,Married,9123,20567,4,Y,No,17,3,1,80,1,18,2,3,12,9,5,7
30,No,Travel_Frequently,567,Research & Development,16,2,Medical,1,2080,3,Female,43,3,1,Laboratory Technician,3,Single,2890,11234,0,Y,Yes,12,3,3,80,0,9,3,1,5,3,1,2
46,No,Non-Travel,1089,Human Resources,25,5,Other,1,2081,2,Male,87,2,5,Manager,1,Divorced,16890,25456,6,Y,No,21,4,2,80,3,23,2,5,17,13,8,10
26,Yes,Travel_Rarely,456,Research & Development,3,1,Life Sciences,1,2082,4,Female,38,4,1,Research Scientist,2,Single,2345,9567,0,Y,No,11,4,4,80,0,5,2,1,3,2,0,1
49,No,Travel_Frequently,1167,Sales,19,4,Marketing,1,2083,1,Male,89,1,4,Manager,4,Married,14123,23234,5,Y,Yes,22,4,1,80,2,26,1,4,18,14,9,11
35,No,Travel_Rarely,678,Research & Development,8,3,Technical Degree,1,2084,3,Female,62,3,2,Healthcare Representative,3,Single,6234,16789,2,Y,No,15,3,3,80,0,13,3,2,8,6,3,4
28,Yes,Non-Travel,567,Sales,12,2,Life Sciences,1,2085,2,Male,45,2,1,Sales Executive,1,Married,5567,14890,1,Y,No,12,3,2,80,0,7,1,1,4,3,1,2
43,No,Travel_Rarely,923,Human Resources,27,5,Human Resources,1,2086,4,Female,81,4,3,Manager,2,Divorced,15234,24678,4,Y,Yes,18,4,4,80,1,20,2,3,14,10,6,8
31,No,Travel_Frequently,634,Research & Development,5,3,Medical,1,2087,1,Male,56,1,1,Research Scientist,4,Single,3678,12567,0,Y,No,13,3,1,80,0,9,2,1,5,3,1,2
37,No,Travel_Rarely,789,Sales,22,4,Marketing,1,2088,3,Female,69,3,2,Sales Executive,3,Married,7890,18456,3,Y,Yes,15,3,3,80,1,14,3,2,9,7,3,5
24,Yes,Non-Travel,456,Research & Development,14,1,Life Sciences,1,2089,2,Male,34,2,1,Laboratory Technician,1,Single,2234,9123,0,Y,No,11,3,2,80,0,3,1,1,1,0,0,0
51,No,Travel_Frequently,1234,Human Resources,1,5,Other,1,2090,4,Female,92,4,5,Manager,4,Married,17567,26234,6,Y,No,23,4,4,80,3,28,2,5,20,16,11,13
32,No,Travel_Rarely,567,Research & Development,17,2,Technical Degree,1,2091,1,Male,47,1,2,Manufacturing Director,2,Single,4890,13678,1,Y,Yes,13,3,1,80,0,10,3,2,6,4,2,3
39,Yes,Travel_Frequently,812,Sales,9,4,Life Sciences,1,2092,3,Female,74,3,2,Sales Executive,3,Divorced,8567,19234,3,Y,No,16,3,3,80,1,16,2,2,10,8,4,6
29,No,Non-Travel,445,Research & Development,24,3,Medical,1,2093,2,Male,41,2,1,Research Scientist,4,Single,3123,11890,0,Y,No,12,3,2,80,0,8,1,1,4,3,1,2
47,No,Travel_Rarely,1089,Human Resources,6,5,Human Resources,1,2094,4,Female,86,4,4,Manager,1,Married,16123,25567,5,Y,Yes,20,4,4,80,2,24,2,4,17,13,8,10
34,No,Travel_Frequently,678,Research & Development,20,3,Life Sciences,1,2095,1,Male,53,1,1,Research Scientist,2,Single,4567,14234,1,Y,No,14,3,1,80,0,12,2,1,7,5,2,4
26,Yes,Travel_Rarely,567,Sales,13,2,Marketing,1,2096,3,Female,39,3,2,Sales Executive,3,Married,5890,15678,2,Y,Yes,11,3,3,80,0,5,3,2,3,2,0,1
42,No,Non-Travel,923,Human Resources,2,4,Other,1,2097,2,Male,78,2,3,Human Resources,4,Divorced,7234,18567,3,Y,No,17,3,2,80,1,19,3,3,12,9,5,7
36,No,Travel_Frequently,634,Research & Development,18,3,Technical Degree,1,2098,4,Female,65,4,2,Healthcare Representative,1,Single,6789,17123,2,Y,Yes,15,4,4,80,0,14,3,2,9,7,3,5
30,Yes,Travel_Rarely,789,Sales,11,2,Life Sciences,1,2099,1,Male,49,1,1,Sales Executive,2,Married,5234,13890,1,Y,No,12,3,1,80,0,9,2,1,4,3,1,2
48,No,Non-Travel,1167,Human Resources,4,5,Human Resources,1,2100,3,Female,84,3,4,Manager,4,Divorced,15890,24567,5,Y,Yes,21,4,3,80,2,25,2,4,18,14,9,11
33,No,Travel_Frequently,634,Research & Development,23,3,Medical,1,2101,2,Male,57,2,1,Research Scientist,3,Single,4123,12890,0,Y,No,13,3,2,80,0,11,2,1,6,4,2,3
40,Yes,Travel_Rarely,812,Sales,16,4,Marketing,1,2102,4,Female,71,4,2,Sales Executive,1,Married,7456,18234,3,Y,Yes,16,4,4,80,1,17,3,2,11,8,4,6
27,No,Travel_Frequently,456,Research & Development,8,2,Life Sciences,1,2103,1,Male,38,1,1,Laboratory Technician,2,Single,2678,10456,0,Y,No,11,3,1,80,0,6,2,1,3,2,0,1
45,No,Non-Travel,1089,Human Resources,19,5,Other,1,2104,3,Female,83,3,5,Manager,3,Married,16567,25123,6,Y,No,20,4,3,80,1,22,2,5,16,12,7,9
31,Yes,Travel_Rarely,567,Research & Development,3,3,Technical Degree,1,2105,2,Male,52,2,2,Manufacturing Director,4,Single,5234,14567,1,Y,Yes,13,3,2,80,0,9,3,2,5,3,1,2
38,No,Travel_Frequently,789,Sales,21,4,Life Sciences,1,2106,4,Female,68,4,3,Sales Executive,2,Divorced,8890,19567,4,Y,No,15,4,4,80,1,15,2,3,10,8,4,6
24,No,Travel_Rarely,445,Research & Development,12,1,Medical,1,2107,1,Male,35,1,1,Research Scientist,1,Single,2345,9234,0,Y,No,11,3,1,80,0,3,1,1,1,0,0,0
52,No,Non-Travel,1234,Human Resources,26,5,Human Resources,1,2108,3,Female,91,3,5,Manager,4,Married,17234,26789,6,Y,Yes,23,4,3,80,3,29,1,5,21,16,11,13
34,Yes,Travel_Frequently,678,Research & Development,5,3,Life Sciences,1,2109,2,Male,59,2,1,Research Scientist,3,Single,4567,13678,1,Y,No,14,3,2,80,0,12,2,1,7,5,2,4
29,No,Travel_Rarely,634,Sales,18,2,Marketing,1,2110,4,Female,46,4,2,Sales Executive,1,Married,6123,16890,2,Y,Yes,12,4,4,80,0,8,3,2,4,3,1,2
41,No,Travel_Frequently,923,Human Resources,9,4,Other,1,2111,1,Male,77,1,3,Human Resources,2,Single,7890,18456,3,Y,No,17,3,1,80,1,18,3,3,12,9,5,7
36,No,Non-Travel,567,Research & Development,14,3,Technical Degree,1,2112,3,Female,63,3,2,Healthcare Representative,3,Divorced,6789,15234,2,Y,Yes,15,3,3,80,0,14,4,2,9,7,3,5
25,Yes,Travel_Rarely,812,Research & Development,1,2,Life Sciences,1,2113,2,Male,39,2,1,Laboratory Technician,4,Single,2456,10123,0,Y,No,11,3,2,80,0,4,2,1,2,1,0,0
47,No,Travel_Frequently,1167,Sales,22,4,Marketing,1,2114,4,Female,86,4,4,Manager,1,Married,14123,23567,5,Y,Yes,19,4,4,80,2,24,1,4,17,13,8,10
32,No,Travel_Rarely,456,Research & Development,7,3,Medical,1,2115,1,Male,51,1,1,Research Scientist,2,Single,3890,12456,0,Y,No,13,3,1,80,0,10,2,1,5,3,1,2
28,Yes,Non-Travel,789,Sales,25,2,Life Sciences,1,2116,3,Female,44,3,2,Sales Executive,3,Married,5678,14890,1,Y,No,12,3,3,80,0,7,1,2,4,3,1,2
44,No,Travel_Rarely,1089,Human Resources,11,5,Human Resources,1,2117,2,Male,82,2,4,Manager,4,Divorced,15456,24234,5,Y,Yes,18,4,2,80,1,21,2,4,15,11,6,8
33,No,Travel_Frequently,634,Research & Development,4,3,Technical Degree,1,2118,4,Female,58,4,1,Research Scientist,1,Single,4234,13567,0,Y,No,14,4,4,80,0,11,2,1,6,4,2,3
39,Yes,Travel_Rarely,567,Sales,17,4,Life Sciences,1,2119,1,Male,74,1,3,Sales Executive,2,Married,8123,19234,3,Y,Yes,16,3,1,80,1,16,3,3,10,8,4,6
26,No,Travel_Frequently,923,Research & Development,28,2,Medical,1,2120,3,Female,41,3,1,Laboratory Technician,3,Single,2789,11456,0,Y,No,11,3,3,80,0,5,2,1,3,2,0,1
50,No,Non-Travel,1234,Human Resources,13,5,Other,1,2121,2,Male,89,2,5,Manager,4,Married,16890,25678,6,Y,No,22,4,2,80,3,27,2,5,19,15,10,12
35,No,Travel_Rarely,678,Research & Development,2,3,Life Sciences,1,2122,4,Female,65,4,2,Healthcare Representative,1,Divorced,7456,17890,2,Y,Yes,15,4,4,80,0,13,3,2,8,6,3,4
31,Yes,Travel_Frequently,812,Sales,20,3,Marketing,1,2123,1,Male,56,1,2,Sales Executive,3,Single,6234,16567,2,Y,No,13,3,1,80,0,9,4,2,6,4,2,3
42,No,Travel_Rarely,456,Human Resources,6,4,Human Resources,1,2124,3,Female,79,3,3,Human Resources,2,Married,8567,19123,3,Y,Yes,17,3,3,80,1,19,3,3,12,9,5,7
29,No,Non-Travel,789,Research & Development,15,2,Technical Degree,1,2125,2,Male,47,2,1,Research Scientist,4,Single,3456,12234,0,Y,No,12,3,2,80,0,8,1,1,4,3,1,2
46,Yes,Travel_Rarely,1167,Sales,9,5,Life Sciences,1,2126,4,Female,85,4,3,Sales Executive,1,Divorced,10234,22456,4,Y,Yes,18,4,4,80,2,23,2,3,16,12,7,9
37,No,Travel_Frequently,634,Research & Development,24,3,Medical,1,2127,1,Male,62,1,2,Manufacturing Director,2,Single,5890,15678,1,Y,No,14,3,1,80,0,14,3,2,8,6,3,4
24,No,Travel_Rarely,567,Sales,10,1,Marketing,1,2128,3,Female,36,3,1,Sales Executive,3,Married,4567,13890,1,Y,No,11,3,3,80,0,3,2,1,1,0,0,0
43,No,Non-Travel,923,Human Resources,3,4,Other,1,2129,2,Male,81,2,4,Manager,4,Single,14789,23567,4,Y,Yes,19,4,2,80,1,20,2,4,14,10,6,8
34,Yes,Travel_Frequently,678,Research & Development,19,3,Life Sciences,1,2130,4,Female,54,4,1,Research Scientist,1,Divorced,4123,14234,0,Y,No,13,4,4,80,0,12,2,1,7,5,2,4
30,No,Travel_Rarely,812,Sales,8,2,Life Sciences,1,2131,1,Male,49,1,2,Sales Executive,2,Married,6789,17456,2,Y,Yes,12,3,1,80,0,9,3,2,5,3,1,2
48,No,Travel_Frequently,1089,Human Resources,21,5,Human Resources,1,2132,3,Female,87,3,5,Manager,3,Single,16234,24890,5,Y,No,21,4,3,80,2,25,1,5,18,14,9,11
27,Yes,Non-Travel,456,Research & Development,16,2,Technical Degree,1,2133,2,Male,38,2,1,Laboratory Technician,4,Single,2345,10567,0,Y,No,11,3,2,80,0,6,2,1,3,2,0,1
41,No,Travel_Rarely,789,Sales,5,4,Marketing,1,2134,4,Female,76,4,3,Sales Executive,1,Married,9123,20234,3,Y,Yes,17,4,4,80,1,18,2,3,12,9,5,7
33,No,Travel_Frequently,634,Research & Development,23,3,Medical,1,2135,1,Male,53,1,1,Research Scientist,2,Single,4567,13456,0,Y,No,14,3,1,80,0,11,2,1,6,4,2,3
38,Yes,Travel_Rarely,567,Human Resources,12,3,Other,1,2136,3,Female,67,3,2,Human Resources,3,Divorced,7234,16789,3,Y,No,15,3,3,80,0,15,3,2,9,7,3,5
25,No,Non-Travel,923,Research & Development,1,1,Life Sciences,1,2137,2,Male,40,2,1,Research Scientist,4,Single,2678,11234,0,Y,Yes,11,3,2,80,0,4,1,1,2,1,0,0
49,No,Travel_Frequently,1167,Sales,18,4,Marketing,1,2138,4,Female,88,4,4,Manager,2,Married,13567,23456,5,Y,No,20,4,4,80,2,26,1,4,18,14,9,11
32,No,Travel_Rarely,678,Research & Development,7,3,Life Sciences,1,2139,1,Male,55,1,2,Healthcare Representative,1,Single,5234,14567,1,Y,Yes,13,3,1,80,0,10,3,2,6,4,2,3
28,Yes,Travel_Frequently,812,Sales,25,2,Life Sciences,1,2140,3,Female,42,3,1,Sales Executive,3,Married,6890,17123,2,Y,No,12,3,3,80,0,7,1,1,4,3,1,2
45,No,Travel_Rarely,456,Human Resources,14,5,Human Resources,1,2141,2,Male,84,2,3,Manager,4,Divorced,15123,24678,4,Y,Yes,18,4,2,80,1,22,2,3,16,12,7,9
36,No,Non-Travel,1089,Research & Development,2,4,Technical Degree,1,2142,4,Female,61,4,2,Research Scientist,2,Single,6456,16890,1,Y,No,15,4,4,80,0,14,3,2,9,7,3,5
31,Yes,Travel_Rarely,634,Sales,20,3,Marketing,1,2143,1,Male,48,1,1,Sales Executive,1,Married,5789,15234,2,Y,Yes,13,3,1,80,0,9,2,1,5,3,1,2
40,No,Travel_Frequently,789,Human Resources,9,4,Other,1,2144,3,Female,73,3,3,Human Resources,3,Single,8234,18567,3,Y,No,16,3,3,80,1,17,3,3,11,8,4,6
26,No,Travel_Rarely,567,Research & Development,17,2,Medical,1,2145,2,Male,39,2,1,Laboratory Technician,4,Single,2456,11890,0,Y,No,11,3,2,80,0,5,2,1,3,2,0,1
52,No,Non-Travel,1234,Sales,4,5,Life Sciences,1,2146,4,Female,91,4,4,Manager,2,Married,16789,25456,5,Y,Yes,23,4,4,80,2,29,1,4,21,16,11,13
33,Yes,Travel_Frequently,678,Research & Development,22,3,Technical Degree,1,2147,1,Male,56,1,1,Research Scientist,3,Single,4123,13567,0,Y,No,13,3,1,80,0,11,2,1,6,4,2,3
39,No,Travel_Rarely,923,Sales,11,4,Marketing,1,2148,3,Female,69,3,2,Sales Executive,4,Divorced,8456,19234,3,Y,Yes,16,3,3,80,1,16,3,2,10,8,4,6
29,No,Travel_Frequently,456,Research & Development,6,2,Life Sciences,1,2149,2,Male,45,2,1,Research Scientist,1,Married,3234,12456,1,Y,No,12,3,2,80,0,8,1,1,4,3,1,2
44,Yes,Non-Travel,1089,Human Resources,26,5,Human Resources,1,2150,4,Female,82,4,5,Manager,3,Single,15890,24123,6,Y,No,19,4,4,80,2,21,2,5,15,11,6,8
35,No,Travel_Rarely,634,Research & Development,13,3,Medical,1,2151,1,Male,58,1,2,Healthcare Representative,2,Divorced,6789,16567,2,Y,Yes,14,3,1,80,0,13,3,2,8,6,3,4
27,No,Travel_Frequently,789,Sales,3,2,Life Sciences,1,2152,3,Female,41,3,1,Sales Executive,1,Single,5123,14890,1,Y,No,11,3,3,80,0,6,2,1,3,2,0,1
51,No,Travel_Rarely,1167,Human Resources,19,4,Other,1,2153,2,Male,86,2,4,Manager,4,Married,16234,25678,5,Y,Yes,22,4,2,80,1,28,2,4,20,15,10,12
34,Yes,Travel_Frequently,567,Research & Development,8,3,Technical Degree,1,2154,4,Female,52,4,1,Research Scientist,3,Single,4567,13234,0,Y,No,14,4,4,80,0,12,2,1,7,5,2,4
30,No,Non-Travel,812,Sales,24,2,Marketing,1,2155,1,Male,47,1,2,Sales Executive,2,Married,6234,17123,2,Y,Yes,12,3,1,80,0,9,3,2,5,3,1,2
47,No,Travel_Rarely,1089,Human Resources,15,5,Human Resources,1,2156,3,Female,85,3,3,Human Resources,1,Divorced,9567,20456,3,Y,No,18,3,3,80,2,24,2,3,17,13,8,10
28,Yes,Travel_Frequently,456,Research & Development,1,2,Life Sciences,1,2157,2,Male,37,2,1,Laboratory Technician,4,Single,2345,10234,0,Y,No,11,3,2,80,0,7,2,1,3,2,0,1
42,No,Travel_Rarely,789,Sales,21,4,Marketing,1,2158,4,Female,74,4,3,Sales Executive,2,Married,8890,19567,4,Y,Yes,17,4,4,80,1,19,2,3,12,9,5,7
37,No,Non-Travel,634,Research & Development,10,3,Medical,1,2159,1,Male,61,1,1,Research Scientist,1,Single,5234,14890,1,Y,No,15,3,1,80,0,14,3,2,9,7,3,5
24,No,Travel_Frequently,923,Sales,5,1,Life Sciences,1,2160,3,Female,34,3,1,Sales Executive,3,Single,4123,12567,0,Y,No,11,3,3,80,0,3,1,1,1,0,0,0
48,Yes,Travel_Rarely,1167,Human Resources,28,5,Other,1,2161,2,Male,83,2,4,Manager,4,Divorced,15678,23890,5,Y,Yes,20,4,2,80,3,25,1,4,18,14,9,11
31,No,Travel_Frequently,567,Research & Development,16,3,Technical Degree,1,2162,4,Female,49,4,2,Manufacturing Director,1,Married,5890,15234,1,Y,No,13,4,4,80,0,9,3,2,5,3,1,2
38,No,Travel_Rarely,812,Sales,7,4,Marketing,1,2163,1,Male,66,1,2,Sales Executive,2,Single,7456,17890,2,Y,Yes,15,3,1,80,1,15,3,2,10,8,4,6
26,Yes,Non-Travel,456,Research & Development,23,2,Life Sciences,1,2164,3,Female,38,3,1,Research Scientist,3,Single,2678,11456,0,Y,No,11,3,3,80,0,5,2,1,3,2,0,1
45,No,Travel_Frequently,1089,Human Resources,12,5,Human Resources,1,2165,2,Male,81,2,5,Manager,4,Married,16123,24567,6,Y,No,19,4,2,80,2,22,2,5,16,12,7,9
32,No,Travel_Rarely,678,Research & Development,4,3,Medical,1,2166,4,Female,54,4,1,Research Scientist,1,Divorced,4234,13678,0,Y,Yes,13,4,4,80,0,10,2,1,6,4,2,3
29,Yes,Travel_Frequently,789,Sales,18,2,Life Sciences,1,2167,1,Male,43,1,1,Sales Executive,2,Married,5567,16234,1,Y,No,12,3,1,80,0,8,1,1,4,3,1,2
43,No,Travel_Rarely,634,Human Resources,9,4,Other,1,2168,3,Female,77,3,3,Human Resources,3,Single,8234,18456,3,Y,Yes,17,3,3,80,1,20,3,3,13,10,5,8
35,No,Non-Travel,1167,Research & Development,25,3,Technical Degree,1,2169,2,Male,59,2,2,Healthcare Representative,4,Married,6789,16890,2,Y,No,14,3,2,80,0,13,4,2,8,6,3,4
27,Yes,Travel_Rarely,456,Sales,14,1,Marketing,1,2170,4,Female,36,4,1,Sales Executive,1,Single,4890,13234,1,Y,Yes,11,4,4,80,0,6,2,1,3,2,0,1
50,No,Travel_Frequently,923,Human Resources,2,5,Human Resources,1,2171,1,Male,87,1,5,Manager,2,Divorced,16567,25123,5,Y,No,21,4,1,80,3,27,2,5,19,15,10,12
33,No,Travel_Rarely,567,Research & Development,20,3,Life Sciences,1,2172,3,Female,51,3,1,Research Scientist,3,Married,4567,14567,0,Y,No,13,3,3,80,0,11,2,1,6,4,2,3
40,Yes,Non-Travel,812,Sales,11,4,Marketing,1,2173,2,Male,73,2,3,Sales Executive,4,Single,8123,19234,3,Y,Yes,16,3,2,80,1,17,3,3,11,8,4,6
28,No,Travel_Frequently,678,Research & Development,6,2,Medical,1,2174,4,Female,44,4,1,Laboratory Technician,2,Married,2890,12456,1,Y,No,12,4,4,80,0,7,1,1,4,3,1,2
46,No,Travel_Rarely,1089,Human Resources,17,5,Other,1,2175,1,Male,84,1,4,Manager,1,Single,15234,23678,4,Y,Yes,18,4,1,80,2,23,2,4,16,12,7,9
34,Yes,Travel_Frequently,456,Research & Development,29,3,Technical Degree,1,2176,3,Female,57,3,2,Manufacturing Director,3,Divorced,5678,15890,1,Y,No,14,3,3,80,0,12,3,2,7,5,2,4
31,No,Travel_Rarely,789,Sales,13,2,Life Sciences,1,2177,2,Male,48,2,1,Sales Executive,4,Married,6234,16567,2,Y,Yes,13,3,2,80,0,9,2,1,5,3,1,2
41,No,Non-Travel,634,Human Resources,3,4,Human Resources,1,2178,4,Female,76,4,2,Human Resources,2,Single,7890,17234,2,Y,No,16,4,4,80,1,18,3,2,11,8,4,6
36,No,Travel_Frequently,1167,Research & Development,21,3,Medical,1,2179,1,Male,63,1,2,Healthcare Representative,1,Married,7456,18123,3,Y,Yes,15,3,1,80,0,14,3,2,9,7,3,5
25,Yes,Travel_Rarely,567,Sales,8,1,Marketing,1,2180,3,Female,35,3,1,Sales Executive,3,Single,4567,12890,0,Y,No,11,3,3,80,0,4,2,1,2,1,0,0
52,No,Travel_Frequently,923,Human Resources,24,5,Other,1,2181,2,Male,89,2,5,Manager,4,Divorced,16890,24567,6,Y,No,22,4,2,80,3,29,1,5,21,16,11,13
30,No,Travel_Rarely,678,Research & Development,15,2,Life Sciences,1,2182,4,Female,46,4,1,Research Scientist,2,Married,3789,13456,1,Y,Yes,12,4,4,80,0,9,2,1,5,3,1,2
47,Yes,Non-Travel,812,Sales,1,4,Marketing,1,2183,1,Male,78,1,3,Sales Executive,1,Single,8234,19567,3,Y,No,17,3,1,80,1,24,3,3,15,11,6,8
33,No,Travel_Frequently,456,Research & Development,19,3,Technical Degree,1,2184,3,Female,55,3,2,Manufacturing Director,4,Married,5234,14890,1,Y,Yes,13,3,3,80,0,11,4,2,6,4,2,3
39,No,Travel_Rarely,1089,Human Resources,10,4,Human Resources,1,2185,2,Male,71,2,3,Human Resources,3,Divorced,8567,18234,4,Y,No,16,3,2,80,1,16,3,3,10,8,4,6
26,Yes,Travel_Frequently,634,Research & Development,5,2,Medical,1,2186,4,Female,39,4,1,Laboratory Technician,1,Single,2456,11567,0,Y,No,11,4,4,80,0,5,2,1,3,2,0,1
44,No,Travel_Rarely,789,Sales,22,4,Life Sciences,1,2187,1,Male,82,1,4,Manager,2,Married,13234,22456,5,Y,Yes,18,4,1,80,2,21,2,4,15,11,6,8
32,No,Non-Travel,567,Research & Development,16,3,Life Sciences,1,2188,3,Female,52,3,1,Research Scientist,3,Single,4123,13789,0,Y,No,13,3,3,80,0,10,2,1,6,4,2,3
28,Yes,Travel_Rarely,1167,Sales,7,2,Marketing,1,2189,2,Male,44,2,1,Sales Executive,4,Married,5890,15234,1,Y,Yes,12,3,2,80,0,7,1,1,4,3,1,2
48,No,Travel_Frequently,456,Human Resources,26,5,Other,1,2190,4,Female,85,4,4,Manager,1,Divorced,15678,23567,5,Y,No,19,4,4,80,2,25,2,4,18,14,9,11
35,No,Travel_Rarely,812,Research & Development,14,3,Technical Degree,1,2191,1,Male,60,1,2,Healthcare Representative,2,Single,6456,16890,2,Y,Yes,14,3,1,80,0,13,3,2,8,6,3,4
31,Yes,Non-Travel,678,Sales,3,2,Life Sciences,1,2192,3,Female,47,3,1,Sales Executive,3,Married,5234,14567,1,Y,No,13,3,3,80,0,9,2,1,5,3,1,2
42,No,Travel_Frequently,923,Human Resources,18,4,Human Resources,1,2193,2,Male,75,2,3,Human Resources,4,Single,8890,19234,3,Y,Yes,17,3,2,80,1,19,3,3,12,9,5,7
37,No,Travel_Rarely,634,Research & Development,9,3,Medical,1,2194,4,Female,64,4,2,Research Scientist,1,Divorced,6789,16567,2,Y,No,15,4,4,80,0,14,3,2,9,7,3,5
24,Yes,Travel_Frequently,1089,Sales,23,1,Marketing,1,2195,1,Male,33,1,1,Sales Executive,2,Single,4123,12890,0,Y,No,11,3,1,80,0,3,1,1,1,0,0,0
49,No,Travel_Rarely,567,Human Resources,12,5,Other,1,2196,3,Female,86,3,5,Manager,3,Married,16234,24678,6,Y,Yes,20,4,3,80,2,26,2,5,18,14,9,11
34,No,Non-Travel,789,Research & Development,4,3,Life Sciences,1,2197,2,Male,56,2,1,Research Scientist,4,Single,4567,14234,0,Y,No,14,3,2,80,0,12,2,1,7,5,2,4
30,Yes,Travel_Frequently,456,Sales,20,2,Marketing,1,2198,4,Female,42,4,1,Sales Executive,1,Married,5890,15678,1,Y,Yes,12,4,4,80,0,9,3,1,4,3,1,2
46,No,Travel_Rarely,1167,Human Resources,11,4,Human Resources,1,2199,1,Male,83,1,4,Manager,2,Divorced,15567,23234,4,Y,No,18,4,1,80,1,23,2,4,16,12,7,9
33,No,Travel_Frequently,678,Research & Development,1,3,Medical,1,1834,2,Female,62,3,1,Research Scientist,1,Married,3591,12719,1,Y,No,22,4,3,80,1,3,3,3,3,2,1,2
42,Yes,Travel_Frequently,1350,Sales,15,4,Marketing,1,1001,2,Male,85,3,3,Sales Executive,3,Single,8750,18500,3,Y,Yes,18,4,2,80,2,15,4,2,8,5,2,4
35,No,Non-Travel,950,Research & Development,8,3,Life Sciences,1,1002,4,Female,72,4,2,Research Scientist,4,Married,5200,12000,2,Y,No,22,3,3,80,1,12,3,3,7,4,1,3
28,Yes,Travel_Rarely,680,Human Resources,22,2,Human Resources,1,1003,1,Female,45,2,1,Human Resources,2,Divorced,3100,8900,1,Y,Yes,16,3,1,80,0,5,2,2,3,1,0,1
51,No,Travel_Frequently,1200,Sales,5,5,Technical Degree,1,1004,3,Male,88,3,4,Manager,3,Married,14200,20500,5,Y,No,20,4,4,80,1,25,3,4,18,12,8,15
39,No,Travel_Rarely,800,Research & Development,12,3,Medical,1,1005,2,Female,65,3,2,Laboratory Technician,3,Single,4800,11200,2,Y,Yes,14,3,2,80,2,14,2,3,9,6,3,7
26,Yes,Travel_Frequently,550,Sales,18,1,Marketing,1,1006,1,Male,38,2,1,Sales Representative,1,Single,2850,7500,0,Y,No,12,3,1,80,0,3,1,2,2,1,0,1
44,No,Non-Travel,1100,Research & Development,3,4,Life Sciences,1,1007,4,Male,78,4,3,Research Director,4,Divorced,12500,16800,4,Y,No,19,4,3,80,0,20,4,3,15,10,6,12
33,No,Travel_Rarely,720,Sales,7,3,Other,1,1008,3,Female,52,3,2,Sales Executive,2,Married,6200,13500,1,Y,Yes,15,3,3,80,1,9,3,2,6,4,1,5
37,Yes,Travel_Frequently,890,Research & Development,25,2,Medical,1,1009,2,Male,67,2,2,Healthcare Representative,2,Single,5400,14200,3,Y,Yes,17,3,2,80,3,13,2,3,8,5,4,6
41,No,Travel_Rarely,1050,Sales,9,4,Marketing,1,1010,4,Female,74,3,3,Sales Executive,4,Married,7800,15600,2,Y,No,21,4,4,80,2,16,3,3,12,8,5,9
29,No,Non-Travel,620,Research & Development,14,2,Life Sciences,1,1011,3,Male,48,3,1,Research Scientist,3,Divorced,3600,9800,1,Y,No,13,3,2,80,1,6,2,2,4,3,1,2
52,Yes,Travel_Rarely,1180,Sales,11,3,Life Sciences,1,1012,1,Female,82,2,4,Manager,2,Married,13800,18900,6,Y,Yes,18,3,3,80,0,28,2,4,22,15,10,18
24,No,Travel_Frequently,480,Human Resources,20,1,Human Resources,1,1013,2,Male,35,1,1,Human Resources,1,Single,2200,6800,0,Y,No,11,3,1,80,0,1,1,1,1,0,0,0
46,No,Travel_Rarely,940,Research & Development,6,4,Technical Degree,1,1014,4,Female,71,4,2,Manufacturing Director,3,Single,8900,14700,3,Y,No,16,4,3,80,1,22,4,2,17,11,7,14
31,Yes,Travel_Frequently,750,Sales,16,3,Marketing,1,1015,2,Male,56,3,2,Sales Executive,2,Married,5900,12800,2,Y,Yes,19,3,2,80,2,8,3,2,5,3,2,3
38,No,Non-Travel,1020,Research & Development,4,3,Medical,1,1016,3,Female,69,3,3,Research Scientist,4,Divorced,6800,13200,4,Y,No,20,4,4,80,2,15,3,3,11,7,4,8
27,No,Travel_Rarely,580,Sales,13,2,Life Sciences,1,1017,1,Male,42,2,1,Sales Representative,1,Single,3200,8600,1,Y,Yes,14,3,1,80,0,4,2,1,3,2,0,2
49,Yes,Travel_Frequently,1250,Research & Development,8,5,Life Sciences,1,1018,4,Female,86,4,4,Research Director,4,Married,15200,21000,7,Y,No,22,4,4,80,1,26,4,4,20,14,9,16
34,No,Travel_Rarely,680,Sales,19,3,Marketing,1,1019,2,Male,51,3,2,Sales Executive,3,Single,5800,11900,2,Y,No,16,3,2,80,1,10,2,2,7,5,2,6
43,No,Non-Travel,1080,Research & Development,2,4,Medical,1,1020,3,Female,75,3,3,Laboratory Technician,3,Married,6400,12600,3,Y,Yes,18,3,3,80,2,19,3,3,14,9,6,11
30,Yes,Travel_Frequently,640,Human Resources,24,2,Human Resources,1,1021,1,Male,44,2,1,Human Resources,2,Divorced,3400,9200,1,Y,No,13,3,1,80,0,7,2,2,4,2,1,3
36,No,Travel_Rarely,820,Sales,10,3,Technical Degree,1,1022,4,Female,61,3,2,Sales Executive,3,Married,6600,13800,2,Y,Yes,17,3,3,80,1,12,3,2,8,6,3,7
25,No,Travel_Frequently,520,Research & Development,17,1,Life Sciences,1,1023,2,Male,39,2,1,Research Scientist,2,Single,2900,7800,0,Y,No,12,3,1,80,0,2,1,1,2,1,0,1
47,Yes,Travel_Rarely,1160,Sales,7,4,Marketing,1,1024,3,Female,79,4,3,Manager,4,Divorced,11800,17200,5,Y,Yes,21,4,4,80,0,24,3,4,19,13,8,15
32,No,Non-Travel,760,Research & Development,21,3,Medical,1,1025,2,Male,58,3,2,Healthcare Representative,2,Married,4600,10800,2,Y,No,15,3,2,80,2,9,2,2,6,4,2,5
40,No,Travel_Rarely,900,Sales,5,4,Life Sciences,1,1026,4,Female,68,3,3,Sales Executive,4,Single,7200,14400,3,Y,No,19,4,3,80,1,17,3,3,13,9,5,10
28,Yes,Travel_Frequently,600,Research & Development,26,2,Other,1,1027,1,Male,46,2,1,Laboratory Technician,1,Married,3000,8200,1,Y,Yes,11,3,1,80,3,5,2,1,3,2,1,2
45,No,Travel_Rarely,1040,Sales,8,3,Marketing,1,1028,3,Female,73,3,3,Sales Executive,3,Divorced,8200,15800,4,Y,No,20,3,3,80,2,21,3,3,16,11,7,13
33,No,Non-Travel,720,Research & Development,15,3,Life Sciences,1,1029,2,Male,55,3,2,Research Scientist,2,Single,4400,11000,2,Y,Yes,14,3,2,80,1,8,2,2,5,3,1,4
39,Yes,Travel_Frequently,980,Sales,12,4,Technical Degree,1,1030,4,Female,76,4,3,Sales Executive,4,Married,8600,16400,3,Y,No,18,4,4,80,0,16,4,3,12,8,4,9
26,No,Travel_Rarely,560,Human Resources,23,1,Human Resources,1,1031,1,Male,41,1,1,Human Resources,1,Single,2600,7200,0,Y,No,10,3,1,80,0,3,1,1,2,1,0,1
50,No,Travel_Frequently,1220,Research & Development,4,5,Medical,1,1032,3,Female,84,4,4,Research Director,3,Married,14600,19800,6,Y,Yes,23,4,3,80,1,27,4,4,21,15,10,17
35,Yes,Travel_Rarely,780,Sales,18,3,Marketing,1,1033,2,Male,59,3,2,Sales Executive,2,Divorced,6000,12400,2,Y,Yes,16,3,2,80,2,11,2,2,7,5,2,6
42,No,Non-Travel,860,Research & Development,6,4,Life Sciences,1,1034,4,Female,66,3,2,Laboratory Technician,4,Married,5600,11800,3,Y,No,17,3,4,80,2,18,3,2,14,10,6,12
29,No,Travel_Rarely,620,Sales,14,2,Other,1,1035,3,Male,47,2,1,Sales Representative,3,Single,3800,8800,1,Y,No,13,3,2,80,0,6,2,1,4,3,1,3
48,Yes,Travel_Frequently,1140,Sales,9,4,Life Sciences,1,1036,1,Female,81,4,4,Manager,2,Married,12400,18200,5,Y,Yes,22,4,3,80,0,25,4,4,19,13,8,16
31,No,Travel_Rarely,700,Research & Development,11,3,Medical,1,1037,2,Male,53,3,2,Research Scientist,3,Divorced,4200,9600,2,Y,No,14,3,2,80,1,7,2,2,5,3,1,4
37,No,Non-Travel,840,Sales,20,3,Marketing,1,1038,4,Female,63,3,3,Sales Executive,4,Single,7000,13600,2,Y,Yes,18,3,4,80,1,14,3,3,10,7,3,8
24,Yes,Travel_Frequently,540,Human Resources,27,1,Human Resources,1,1039,1,Male,37,1,1,Human Resources,1,Married,2400,6900,0,Y,No,12,3,1,80,0,1,1,1,1,0,0,0
46,No,Travel_Rarely,960,Research & Development,7,4,Technical Degree,1,1040,3,Female,70,4,3,Manufacturing Director,3,Single,9200,15200,4,Y,No,19,4,3,80,1,23,4,3,17,12,7,14
32,No,Travel_Frequently,680,Sales,16,3,Life Sciences,1,1041,2,Male,50,3,2,Sales Executive,2,Married,5600,11400,2,Y,Yes,15,3,2,80,2,9,3,2,6,4,2,5
41,Yes,Non-Travel,1020,Research & Development,3,4,Medical,1,1042,4,Female,74,3,3,Research Scientist,4,Divorced,6600,12800,4,Y,No,20,4,4,80,2,17,3,3,13,8,5,10
27,No,Travel_Rarely,580,Sales,19,2,Marketing,1,1043,1,Male,43,2,1,Sales Representative,1,Single,3400,8400,1,Y,No,13,3,1,80,0,4,2,1,3,2,0,2
49,No,Travel_Frequently,1180,Research & Development,8,5,Life Sciences,1,1044,3,Female,83,4,4,Research Director,3,Married,14800,20400,6,Y,Yes,21,4,3,80,1,26,4,4,20,14,9,17
34,Yes,Travel_Rarely,720,Sales,13,3,Other,1,1045,2,Male,52,3,2,Sales Executive,2,Single,5400,10800,2,Y,No,16,3,2,80,1,10,2,2,7,5,2,6
38,No,Non-Travel,880,Research & Development,22,3,Medical,1,1046,4,Female,65,3,2,Laboratory Technician,4,Married,5200,11600,3,Y,Yes,17,3,4,80,2,15,3,2,11,7,4,9
30,No,Travel_Frequently,640,Human Resources,25,2,Human Resources,1,1047,1,Male,45,2,1,Human Resources,1,Divorced,3200,8600,1,Y,No,14,3,1,80,0,7,2,2,4,2,1,3
43,Yes,Travel_Rarely,940,Sales,10,4,Marketing,1,1048,3,Female,71,3,3,Sales Executive,3,Married,7600,14800,3,Y,Yes,19,3,3,80,1,19,3,3,14,10,6,12
28,No,Travel_Frequently,600,Research & Development,17,2,Life Sciences,1,1049,2,Male,44,2,1,Research Scientist,2,Single,3000,7600,1,Y,No,12,3,1,80,0,5,1,1,3,2,0,2
47,No,Non-Travel,1100,Sales,5,4,Technical Degree,1,1050,4,Female,77,4,3,Manager,4,Divorced,10800,16800,5,Y,No,20,4,4,80,0,24,4,4,18,12,8,15
35,Yes,Travel_Rarely,760,Research & Development,21,3,Medical,1,1051,1,Male,57,3,2,Healthcare Representative,1,Married,4800,10400,2,Y,Yes,15,3,2,80,3,12,2,2,8,5,3,7
40,No,Travel_Frequently,920,Sales,8,3,Life Sciences,1,1052,3,Female,67,3,3,Sales Executive,3,Single,7400,14200,3,Y,No,18,3,3,80,1,16,3,3,12,8,4,10
26,No,Travel_Rarely,540,Research & Development,24,1,Other,1,1053,2,Male,40,2,1,Laboratory Technician,2,Married,2800,7400,0,Y,No,11,3,1,80,0,3,2,1,2,1,0,1
51,Yes,Travel_Frequently,1200,Sales,6,5,Marketing,1,1054,4,Female,85,4,4,Manager,4,Divorced,13200,19200,6,Y,Yes,22,4,4,80,0,28,4,4,22,16,11,19
33,No,Non-Travel,700,Research & Development,18,3,Life Sciences,1,1055,3,Male,54,3,2,Research Scientist,3,Single,4600,10200,2,Y,No,14,3,2,80,1,9,2,2,6,4,2,5
36,No,Travel_Rarely,800,Sales,12,3,Medical,1,1056,2,Female,60,3,2,Sales Executive,2,Married,6200,12600,2,Y,Yes,17,3,2,80,2,13,3,2,9,6,3,8
29,Yes,Travel_Frequently,620,Human Resources,26,2,Human Resources,1,1057,1,Male,42,2,1,Human Resources,1,Single,3000,8000,1,Y,No,13,3,1,80,0,6,2,1,4,2,1,3
45,No,Travel_Rarely,980,Research & Development,7,4,Technical Degree,1,1058,4,Female,72,4,3,Manufacturing Director,4,Married,8800,15600,4,Y,No,19,4,4,80,1,22,4,3,16,11,7,13
31,No,Non-Travel,660,Sales,15,3,Marketing,1,1059,3,Male,49,3,2,Sales Executive,3,Divorced,5000,10600,2,Y,Yes,15,3,2,80,2,8,2,2,5,3,1,4
39,Yes,Travel_Frequently,860,Research & Development,9,3,Life Sciences,1,1060,2,Female,64,3,2,Research Scientist,2,Single,5400,11200,3,Y,No,16,3,2,80,1,16,2,2,12,8,4,10
25,No,Travel_Rarely,520,Sales,20,1,Other,1,1061,1,Male,36,1,1,Sales Representative,1,Married,2600,7000,0,Y,No,12,3,1,80,0,2,1,1,2,1,0,1
48,No,Travel_Frequently,1120,Research & Development,4,5,Medical,1,1062,4,Female,79,4,4,Research Director,3,Married,13600,18800,5,Y,Yes,21,4,3,80,1,25,4,4,19,13,8,16
34,Yes,Travel_Rarely,740,Sales,17,3,Marketing,1,1063,3,Male,55,3,2,Sales Executive,2,Divorced,5800,11800,2,Y,No,17,3,2,80,2,11,2,2,7,5,2,6
42,No,Non-Travel,900,Research & Development,11,4,Life Sciences,1,1064,2,Female,68,3,3,Laboratory Technician,3,Single,6000,12200,3,Y,Yes,18,3,3,80,2,18,3,3,14,9,6,11
27,No,Travel_Frequently,560,Human Resources,23,2,Human Resources,1,1065,1,Male,41,2,1,Human Resources,1,Married,2800,7600,1,Y,No,14,3,1,80,0,4,2,1,3,2,0,2
50,Yes,Travel_Rarely,1160,Sales,8,4,Technical Degree,1,1066,4,Female,82,4,3,Manager,4,Single,12000,17600,5,Y,Yes,20,4,4,80,0,27,4,3,21,14,9,17
32,No,Travel_Frequently,680,Research & Development,19,3,Medical,1,1067,2,Male,51,3,2,Research Scientist,2,Married,4400,9800,2,Y,No,15,3,2,80,1,9,2,2,6,4,2,5
37,No,Non-Travel,820,Sales,13,3,Life Sciences,1,1068,3,Female,62,3,2,Sales Executive,3,Divorced,6400,13000,2,Y,Yes,16,3,3,80,2,14,3,2,10,7,3,8
28,Yes,Travel_Rarely,580,Research & Development,25,2,Other,1,1069,1,Male,43,2,1,Laboratory Technician,1,Single,3200,8200,1,Y,No,13,3,1,80,0,5,2,1,3,2,1,2
46,No,Travel_Frequently,1000,Sales,6,4,Marketing,1,1070,4,Female,75,3,3,Sales Executive,4,Married,8000,15200,4,Y,No,19,3,4,80,1,21,3,3,15,11,6,12
33,No,Travel_Rarely,720,Research & Development,16,3,Life Sciences,1,1071,3,Male,56,3,2,Research Scientist,3,Single,4800,10800,2,Y,Yes,14,3,2,80,1,10,2,2,7,5,2,6
41,Yes,Non-Travel,920,Sales,10,4,Technical Degree,1,1072,2,Female,69,3,3,Sales Executive,2,Divorced,7200,14400,3,Y,No,18,3,3,80,2,17,3,3,13,8,5,10
29,No,Travel_Frequently,620,Human Resources,22,2,Human Resources,1,1073,1,Male,44,2,1,Human Resources,1,Married,3400,8600,1,Y,No,12,3,1,80,0,6,2,1,4,2,1,3
44,No,Travel_Rarely,960,Research & Development,7,4,Medical,1,1074,4,Female,73,4,3,Manufacturing Director,4,Single,9000,15800,4,Y,Yes,20,4,4,80,1,20,4,3,15,10,7,13
30,Yes,Travel_Frequently,640,Sales,18,2,Marketing,1,1075,2,Male,48,2,2,Sales Executive,2,Single,4000,9200,2,Y,No,15,3,2,80,0,7,2,2,5,3,1,4
38,No,Non-Travel,840,Research & Development,12,3,Life Sciences,1,1076,3,Female,63,3,2,Research Scientist,3,Married,5600,11400,3,Y,No,17,3,3,80,2,15,3,2,11,7,4,9
26,No,Travel_Rarely,540,Sales,24,1,Other,1,1077,1,Male,39,1,1,Sales Representative,1,Divorced,2800,7200,0,Y,Yes,11,3,1,80,0,3,1,1,2,1,0,1
52,Yes,Travel_Frequently,1220,Research & Development,5,5,Medical,1,1078,4,Female,86,4,4,Research Director,3,Married,14200,20000,6,Y,No,23,4,3,80,1,29,4,4,23,17,12,20
35,No,Travel_Rarely,760,Sales,14,3,Marketing,1,1079,3,Male,57,3,2,Sales Executive,3,Single,6000,12000,2,Y,Yes,16,3,2,80,1,12,2,2,8,6,3,7
43,No,Non-Travel,920,Research & Development,8,4,Life Sciences,1,1080,2,Female,70,3,3,Laboratory Technician,2,Married,6400,12800,4,Y,No,18,3,3,80,2,19,3,3,15,10,6,12
31,Yes,Travel_Frequently,660,Human Resources,21,3,Human Resources,1,1081,1,Male,46,2,1,Human Resources,1,Divorced,3600,8800,1,Y,No,14,3,1,80,0,8,2,1,5,3,1,4
40,No,Travel_Rarely,880,Sales,9,3,Technical Degree,1,1082,4,Female,66,3,3,Sales Executive,4,Single,7000,13800,3,Y,Yes,19,3,4,80,1,17,3,3,13,8,5,10
27,No,Travel_Frequently,560,Research & Development,17,2,Medical,1,1083,2,Male,42,2,1,Research Scientist,2,Married,3000,7800,1,Y,No,13,3,1,80,0,4,2,1,3,2,0,2
49,Yes,Non-Travel,1140,Sales,11,4,Life Sciences,1,1084,3,Female,78,4,3,Manager,3,Single,11400,17200,5,Y,Yes,21,4,3,80,0,26,4,3,20,14,9,16
36,No,Travel_Rarely,800,Research & Development,15,3,Other,1,1085,1,Male,59,3,2,Healthcare Representative,1,Divorced,5200,10600,2,Y,No,15,3,2,80,3,13,2,2,9,6,3,8
42,No,Travel_Frequently,940,Sales,6,4,Marketing,1,1086,4,Female,72,3,3,Sales Executive,4,Married,7800,14600,3,Y,No,18,3,4,80,1,18,3,3,14,10,6,11
28,Yes,Travel_Rarely,580,Research & Development,20,2,Life Sciences,1,1087,2,Male,43,2,1,Laboratory Technician,2,Single,3200,8000,1,Y,Yes,12,3,1,80,0,5,2,1,3,2,1,2
45,No,Non-Travel,1000,Sales,13,4,Technical Degree,1,1088,3,Female,75,4,3,Sales Executive,3,Married,8400,15400,4,Y,No,19,4,3,80,2,22,3,3,16,11,7,13
32,No,Travel_Frequently,700,Research & Development,18,3,Medical,1,1089,4,Male,54,3,2,Research Scientist,4,Divorced,4600,10200,2,Y,Yes,16,3,4,80,1,9,2,2,6,4,2,5
39,Yes,Travel_Rarely,860,Sales,10,3,Life Sciences,1,1090,1,Female,65,3,2,Sales Executive,1,Single,6600,12800,3,Y,No,17,3,2,80,1,16,3,2,12,8,4,10
24,No,Travel_Frequently,520,Human Resources,26,1,Human Resources,1,1091,2,Male,38,1,1,Human Resources,2,Married,2400,6800,0,Y,No,11,3,1,80,0,1,1,1,1,0,0,0
47,No,Non-Travel,1080,Research & Development,7,5,Medical,1,1092,3,Female,80,4,4,Research Director,3,Single,12800,18400,5,Y,Yes,22,4,3,80,1,24,4,4,18,12,8,15
34,Yes,Travel_Rarely,740,Sales,16,3,Marketing,1,1093,2,Male,55,3,2,Sales Executive,2,Married,5800,11600,2,Y,No,15,3,2,80,2,11,2,2,7,5,2,6
41,No,Travel_Frequently,900,Research & Development,12,4,Life Sciences,1,1094,4,Female,68,3,3,Laboratory Technician,4,Divorced,6200,12400,3,Y,Yes,18,3,4,80,2,17,3,3,13,8,5,10
30,No,Travel_Rarely,640,Sales,19,2,Other,1,1095,1,Male,47,2,1,Sales Representative,1,Single,3800,8400,1,Y,No,14,3,1,80,0,7,2,1,5,3,1,4
48,Yes,Non-Travel,1120,Sales,8,4,Technical Degree,1,1096,3,Female,76,4,3,Manager,3,Married,11000,16600,5,Y,Yes,20,4,3,80,0,25,4,3,19,13,8,16
33,No,Travel_Frequently,720,Research & Development,15,3,Medical,1,1097,2,Male,53,3,2,Research Scientist,2,Single,4800,10000,2,Y,No,13,3,2,80,1,10,2,2,7,5,2,6
37,No,Travel_Rarely,820,Sales,11,3,Life Sciences,1,1098,4,Female,61,3,2,Sales Executive,4,Married,6800,13200,2,Y,Yes,17,3,4,80,2,14,3,2,10,7,3,8
25,Yes,Travel_Frequently,540,Human Resources,23,1,Human Resources,1,1099,1,Male,39,1,1,Human Resources,1,Divorced,2600,7000,0,Y,No,12,3,1,80,0,2,1,1,2,1,0,1
46,No,Non-Travel,1020,Research & Development,9,4,Medical,1,1100,4,Female,74,4,3,Manufacturing Director,4,Single,9200,15200,4,Y,No,21,4,4,80,1,23,4,3,17,12,7,14
31,No,Travel_Rarely,680,Sales,17,3,Marketing,1,1101,3,Male,50,3,2,Sales Executive,3,Married,5400,10800,2,Y,Yes,16,3,2,80,2,8,2,2,5,3,1,4
38,Yes,Travel_Frequently,840,Research & Development,13,3,Life Sciences,1,1102,2,Female,63,3,2,Research Scientist,2,Single,5800,11600,3,Y,No,18,3,2,80,1,15,2,2,11,7,4,9
26,No,Travel_Rarely,560,Sales,25,1,Other,1,1103,1,Male,40,1,1,Sales Representative,1,Married,3000,7400,0,Y,No,11,3,1,80,0,3,1,1,2,1,0,1
50,No,Travel_Frequently,1180,Research & Development,6,5,Technical Degree,1,1104,4,Female,83,4,4,Research Director,3,Divorced,13800,19400,6,Y,Yes,23,4,3,80,1,27,4,4,21,15,10,18
35,Yes,Travel_Rarely,760,Sales,14,3,Medical,1,1105,3,Male,56,3,2,Sales Executive,2,Single,6200,12200,2,Y,No,17,3,2,80,1,12,2,2,8,6,3,7
43,No,Non-Travel,920,Research & Development,10,4,Life Sciences,1,1106,2,Female,69,3,3,Laboratory Technician,2,Married,6600,13000,4,Y,Yes,19,3,3,80,2,20,3,3,15,10,6,12
29,No,Travel_Frequently,600,Human Resources,22,2,Human Resources,1,1107,1,Male,44,2,1,Human Resources,1,Divorced,3400,8200,1,Y,No,13,3,1,80,0,6,2,1,4,2,1,3
44,Yes,Travel_Rarely,980,Sales,8,4,Marketing,1,1108,4,Female,73,3,3,Sales Executive,4,Married,8200,15000,3,Y,Yes,20,3,4,80,1,20,3,3,14,10,6,11
32,No,Non-Travel,700,Research & Development,16,3,Medical,1,1109,3,Male,52,3,2,Research Scientist,3,Single,4800,10400,2,Y,No,14,3,2,80,1,9,2,2,6,4,2,5
40,No,Travel_Frequently,880,Sales,12,3,Life Sciences,1,1110,2,Female,66,3,2,Sales Executive,2,Divorced,7000,13600,3,Y,Yes,18,3,2,80,2,17,3,2,13,8,5,10
27,Yes,Travel_Rarely,580,Research & Development,24,2,Other,1,1111,1,Male,42,2,1,Laboratory Technician,1,Married,3000,7800,1,Y,No,12,3,1,80,0,4,2,1,3,2,0,2
51,No,Travel_Frequently,1200,Sales,5,5,Technical Degree,1,1112,4,Female,85,4,4,Manager,4,Single,12600,18800,6,Y,No,22,4,4,80,0,28,4,4,22,16,11,19
36,No,Travel_Rarely,800,Research & Development,18,3,Medical,1,1113,3,Male,59,3,2,Healthcare Representative,3,Married,5400,11000,2,Y,Yes,15,3,3,80,3,13,2,2,9,6,3,8
42,Yes,Non-Travel,920,Sales,11,4,Life Sciences,1,1114,2,Female,70,3,3,Sales Executive,2,Single,7400,14200,3,Y,No,19,3,3,80,1,18,3,3,14,9,6,11
28,No,Travel_Frequently,600,Research & Development,21,2,Marketing,1,1115,1,Male,43,2,1,Research Scientist,1,Divorced,3200,8000,1,Y,Yes,13,3,1,80,0,5,2,1,3,2,1,2
47,No,Travel_Rarely,1060,Sales,7,4,Life Sciences,1,1116,4,Female,76,4,3,Sales Executive,4,Married,8800,15600,4,Y,No,21,4,4,80,2,24,3,3,18,12,8,15
33,Yes,Travel_Frequently,720,Research & Development,15,3,Medical,1,1117,2,Male,54,3,2,Research Scientist,2,Single,4600,10200,2,Y,No,16,3,2,80,1,10,2,2,7,5,2,6
39,No,Non-Travel,860,Sales,9,3,Technical Degree,1,1118,3,Female,64,3,2,Sales Executive,3,Married,6800,13400,3,Y,Yes,17,3,3,80,2,16,3,2,12,8,4,10
24,No,Travel_Rarely,520,Human Resources,26,1,Human Resources,1,1119,1,Male,37,1,1,Human Resources,1,Single,2400,6600,0,Y,No,10,3,1,80,0,1,1,1,1,0,0,0
48,Yes,Travel_Frequently,1120,Research & Development,4,5,Life Sciences,1,1120,4,Female,81,4,4,Research Director,3,Divorced,14000,19600,5,Y,Yes,24,4,3,80,1,25,4,4,19,13,8,16
34,No,Travel_Rarely,740,Sales,17,3,Other,1,1121,3,Male,55,3,2,Sales Executive,3,Married,5800,11400,2,Y,No,15,3,2,80,1,11,2,2,7,5,2,6
41,No,Non-Travel,900,Research & Development,13,4,Medical,1,1122,2,Female,67,3,3,Laboratory Technician,2,Single,6000,12600,4,Y,Yes,18,3,3,80,2,18,3,3,14,9,6,11
30,Yes,Travel_Frequently,640,Sales,19,2,Marketing,1,1123,1,Male,46,2,1,Sales Representative,1,Married,3600,8600,1,Y,No,14,3,1,80,0,7,2,1,5,3,1,4
45,No,Travel_Rarely,1000,Research & Development,8,4,Life Sciences,1,1124,4,Female,74,4,3,Manufacturing Director,4,Divorced,9000,15800,4,Y,No,20,4,4,80,1,22,4,3,16,11,7,13
31,No,Travel_Frequently,680,Sales,20,3,Technical Degree,1,1125,2,Male,51,3,2,Sales Executive,2,Single,5200,10800,2,Y,Yes,13,3,2,80,0,8,2,2,5,3,1,4
37,Yes,Non-Travel,820,Research & Development,12,3,Medical,1,1126,3,Female,62,3,2,Research Scientist,3,Married,5600,11800,3,Y,No,17,3,3,80,2,14,3,2,10,7,3,8
26,No,Travel_Rarely,560,Sales,24,1,Life Sciences,1,1127,1,Male,39,1,1,Sales Representative,1,Divorced,2800,7200,0,Y,No,12,3,1,80,0,3,1,1,2,1,0,1
52,No,Travel_Frequently,1220,Research & Development,6,5,Other,1,1128,4,Female,86,4,4,Research Director,3,Single,14400,20200,6,Y,Yes,25,4,3,80,1,29,4,4,23,17,12,20
35,Yes,Travel_Rarely,760,Sales,16,3,Marketing,1,1129,3,Male,57,3,2,Sales Executive,2,Married,6000,12000,2,Y,No,16,3,2,80,2,12,2,2,8,6,3,7
43,No,Non-Travel,940,Research & Development,10,4,Life Sciences,1,1130,2,Female,71,3,3,Laboratory Technician,2,Single,6400,13200,4,Y,Yes,19,3,3,80,2,20,3,3,15,10,6,12
32,No,Travel_Frequently,700,Human Resources,22,3,Human Resources,1,1131,1,Male,49,2,1,Human Resources,1,Divorced,3800,9000,1,Y,No,15,3,1,80,0,9,2,1,6,3,2,4
40,Yes,Travel_Rarely,880,Sales,14,3,Technical Degree,1,1132,4,Female,66,3,3,Sales Executive,4,Married,7200,14000,3,Y,Yes,18,3,4,80,1,17,3,3,13,8,5,10
28,No,Travel_Frequently,600,Research & Development,25,2,Medical,1,1133,2,Male,44,2,1,Research Scientist,2,Single,3400,8200,1,Y,No,13,3,1,80,0,5,2,1,3,2,0,2
49,No,Non-Travel,1160,Sales,7,4,Life Sciences,1,1134,3,Female,79,4,3,Manager,3,Divorced,11600,17800,5,Y,No,22,4,3,80,0,26,4,3,20,14,9,16
36,Yes,Travel_Rarely,800,Research & Development,18,3,Other,1,1135,1,Male,59,3,2,Healthcare Representative,1,Married,5200,11200,2,Y,Yes,14,3,2,80,3,13,2,2,9,6,3,8
42,No,Travel_Frequently,920,Sales,11,4,Marketing,1,1136,4,Female,69,3,3,Sales Executive,4,Single,7600,14400,3,Y,No,19,3,4,80,1,18,3,3,14,10,6,11
27,No,Travel_Rarely,580,Research & Development,23,2,Life Sciences,1,1137,2,Male,42,2,1,Laboratory Technician,2,Married,3000,7600,1,Y,Yes,12,3,1,80,0,4,2,1,3,2,1,2
44,Yes,Non-Travel,980,Sales,9,4,Technical Degree,1,1138,3,Female,73,4,3,Sales Executive,3,Divorced,8000,15200,4,Y,No,20,4,3,80,2,21,3,3,15,11,6,12
33,No,Travel_Frequently,720,Research & Development,15,3,Medical,1,1139,4,Male,53,3,2,Research Scientist,4,Single,4800,10400,2,Y,Yes,17,3,4,80,1,10,2,2,7,5,2,6
38,No,Travel_Rarely,840,Sales,12,3,Life Sciences,1,1140,1,Female,63,3,2,Sales Executive,1,Married,6600,13000,3,Y,No,16,3,2,80,2,15,3,2,11,7,4,9
29,Yes,Travel_Frequently,620,Human Resources,21,2,Human Resources,1,1141,2,Male,45,2,1,Human Resources,2,Single,3200,8400,1,Y,No,14,3,1,80,0,6,2,1,4,2,1,3
46,No,Non-Travel,1040,Research & Development,8,4,Other,1,1142,3,Female,75,4,3,Manufacturing Director,3,Married,8800,15600,4,Y,Yes,21,4,3,80,1,23,4,3,17,12,7,14
31,No,Travel_Rarely,680,Sales,17,3,Marketing,1,1143,2,Male,50,3,2,Sales Executive,2,Divorced,5400,10600,2,Y,No,15,3,2,80,2,8,2,2,5,3,1,4
39,Yes,Travel_Frequently,860,Research & Development,13,3,Life Sciences,1,1144,4,Female,64,3,2,Research Scientist,4,Single,5800,11800,3,Y,Yes,18,3,4,80,1,16,2,2,12,8,4,10
25,No,Travel_Rarely,540,Sales,26,1,Technical Degree,1,1145,1,Male,38,1,1,Sales Representative,1,Married,2600,7000,0,Y,No,11,3,1,80,0,2,1,1,2,1,0,1
50,No,Travel_Frequently,1180,Research & Development,5,5,Medical,1,1146,4,Female,82,4,4,Research Director,3,Single,13600,19200,6,Y,No,23,4,3,80,1,27,4,4,21,15,10,18
34,Yes,Travel_Rarely,740,Sales,16,3,Life Sciences,1,1147,3,Male,55,3,2,Sales Executive,2,Married,5800,11400,2,Y,Yes,16,3,2,80,2,11,2,2,7,5,2,6
41,No,Non-Travel,900,Research & Development,10,4,Other,1,1148,2,Female,68,3,3,Laboratory Technician,2,Divorced,6200,12800,4,Y,No,19,3,3,80,2,18,3,3,14,9,6,11
30,No,Travel_Frequently,640,Human Resources,24,2,Human Resources,1,1149,1,Male,46,2,1,Human Resources,1,Single,3600,8800,1,Y,Yes,13,3,1,80,0,7,2,1,5,3,1,4
47,Yes,Travel_Rarely,1080,Sales,7,4,Marketing,1,1150,4,Female,77,4,3,Manager,4,Married,10200,16800,5,Y,No,22,4,4,80,0,24,4,3,18,12,8,15
32,No,Travel_Frequently,700,Research & Development,19,3,Life Sciences,1,1151,3,Male,52,3,2,Research Scientist,3,Single,4600,10200,2,Y,Yes,14,3,2,80,1,9,2,2,6,4,2,5
38,No,Travel_Rarely,840,Sales,11,3,Technical Degree,1,1152,2,Female,63,3,2,Sales Executive,2,Married,6800,13400,3,Y,No,17,3,2,80,2,15,3,2,11,7,4,9
26,Yes,Travel_Frequently,560,Research & Development,23,1,Medical,1,1153,1,Male,40,1,1,Laboratory Technician,1,Divorced,2800,7400,0,Y,No,12,3,1,80,0,3,1,1,2,1,0,1
51,No,Non-Travel,1200,Sales,6,5,Life Sciences,1,1154,4,Female,84,4,4,Sales Executive,4,Single,11800,17600,5,Y,Yes,21,4,4,80,1,28,4,4,22,16,11,19
35,No,Travel_Rarely,760,Research & Development,14,3,Other,1,1155,3,Male,56,3,2,Healthcare Representative,3,Married,5000,10800,2,Y,No,15,3,3,80,3,12,2,2,8,6,3,7
43,Yes,Travel_Frequently,940,Sales,9,4,Marketing,1,1156,2,Female,70,3,3,Sales Executive,2,Single,7800,14800,3,Y,Yes,19,3,3,80,1,19,3,3,14,10,6,12
29,No,Travel_Rarely,620,Research & Development,20,2,Life Sciences,1,1157,4,Male,44,2,1,Research Scientist,4,Married,3400,8000,1,Y,No,13,3,4,80,0,6,2,1,4,2,1,3
48,No,Non-Travel,1140,Sales,8,4,Technical Degree,1,1158,1,Female,79,4,3,Manager,1,Divorced,12000,17400,5,Y,No,20,4,2,80,0,25,4,3,19,13,8,16
33,Yes,Travel_Frequently,720,Research & Development,17,3,Medical,1,1159,3,Male,53,3,2,Research Scientist,3,Single,4800,10600,2,Y,Yes,16,3,2,80,1,10,2,2,7,5,2,6
40,No,Travel_Rarely,880,Sales,12,3,Life Sciences,1,1160,2,Female,66,3,2,Sales Executive,2,Married,7000,13600,3,Y,No,18,3,2,80,2,17,3,2,13,8,5,10
27,No,Travel_Frequently,580,Human Resources,25,2,Human Resources,1,1161,1,Male,42,2,1,Human Resources,1,Single,3000,7800,1,Y,Yes,14,3,1,80,0,4,2,1,3,2,0,2
45,Yes,Non-Travel,1000,Research & Development,6,4,Other,1,1162,4,Female,74,4,3,Manufacturing Director,4,Married,9200,15800,4,Y,No,21,4,4,80,1,22,4,3,16,11,7,13
31,No,Travel_Rarely,680,Sales,18,3,Marketing,1,1163,3,Male,50,3,2,Sales Executive,3,Divorced,5400,10800,2,Y,Yes,15,3,2,80,2,8,2,2,5,3,1,4
37,No,Travel_Frequently,820,Research & Development,13,3,Life Sciences,1,1164,2,Female,61,3,2,Research Scientist,2,Single,5600,11600,3,Y,No,17,3,2,80,1,14,3,2,10,7,3,8
28,Yes,Travel_Rarely,600,Sales,21,2,Technical Degree,1,1165,1,Male,43,2,1,Sales Representative,1,Married,3200,8200,1,Y,No,13,3,1,80,0,5,2,1,3,2,1,2
52,No,Travel_Frequently,1220,Research & Development,4,5,Medical,1,1166,4,Female,85,4,4,Research Director,3,Single,14200,20000,6,Y,Yes,24,4,3,80,1,29,4,4,23,17,12,20
36,No,Non-Travel,800,Sales,15,3,Life Sciences,1,1167,3,Male,58,3,2,Sales Executive,3,Married,6200,12400,2,Y,No,16,3,2,80,2,13,2,2,9,6,3,8
42,Yes,Travel_Rarely,920,Research & Development,10,4,Other,1,1168,2,Female,69,3,3,Laboratory Technician,2,Divorced,6400,13000,4,Y,Yes,18,3,3,80,2,18,3,3,14,9,6,11
30,No,Travel_Frequently,640,Human Resources,22,2,Human Resources,1,1169,1,Male,45,2,1,Human Resources,1,Single,3400,8600,1,Y,No,14,3,1,80,0,7,2,1,5,3,1,4
44,No,Travel_Rarely,980,Sales,8,4,Marketing,1,1170,4,Female,72,3,3,Sales Executive,4,Married,8200,15400,3,Y,Yes,20,3,4,80,1,20,3,3,14,10,6,11
32,Yes,Travel_Frequently,700,Research & Development,16,3,Life Sciences,1,1171,3,Male,51,3,2,Research Scientist,3,Single,4800,10400,2,Y,No,15,3,2,80,1,9,2,2,6,4,2,5
39,No,Non-Travel,860,Sales,11,3,Technical Degree,1,1172,2,Female,64,3,2,Sales Executive,2,Married,6800,13800,3,Y,Yes,17,3,2,80,2,16,3,2,12,8,4,10
26,No,Travel_Rarely,560,Research & Development,24,1,Medical,1,1173,1,Male,39,1,1,Laboratory Technician,1,Divorced,2800,7200,0,Y,No,11,3,1,80,0,3,1,1,2,1,0,1
49,Yes,Travel_Frequently,1160,Sales,7,4,Life Sciences,1,1174,4,Female,80,4,3,Manager,4,Single,11400,17200,5,Y,No,23,4,4,80,0,26,4,3,20,14,9,16
34,No,Travel_Rarely,740,Research & Development,17,3,Other,1,1175,3,Male,54,3,2,Healthcare Representative,3,Married,5000,10600,2,Y,Yes,16,3,3,80,3,11,2,2,7,5,2,6
41,No,Travel_Frequently,900,Sales,13,4,Marketing,1,1176,2,Female,67,3,3,Sales Executive,2,Single,7400,14200,3,Y,No,19,3,3,80,1,18,3,3,14,9,6,11
28,Yes,Non-Travel,600,Research & Development,25,2,Life Sciences,1,1177,1,Male,43,2,1,Research Scientist,1,Married,3200,8000,1,Y,Yes,12,3,1,80,0,5,2,1,3,2,1,2
46,No,Travel_Rarely,1040,Sales,9,4,Technical Degree,1,1178,4,Female,75,4,3,Sales Executive,4,Divorced,8600,15600,4,Y,No,21,4,4,80,2,23,3,3,17,12,7,14
33,No,Travel_Frequently,720,Research & Development,14,3,Medical,1,1179,3,Male,52,3,2,Research Scientist,3,Single,4600,10200,2,Y,Yes,14,3,2,80,1,10,2,2,7,5,2,6
38,Yes,Travel_Rarely,840,Sales,10,3,Life Sciences,1,1180,2,Female,62,3,2,Sales Executive,2,Married,6600,13400,3,Y,No,18,3,2,80,2,15,3,2,11,7,4,9
25,No,Travel_Frequently,540,Human Resources,26,1,Human Resources,1,1181,1,Male,37,1,1,Human Resources,1,Single,2400,6800,0,Y,No,10,3,1,80,0,2,1,1,2,1,0,1
50,No,Non-Travel,1180,Research & Development,5,5,Other,1,1182,4,Female,83,4,4,Research Director,3,Divorced,13800,19400,6,Y,Yes,25,4,3,80,1,27,4,4,21,15,10,18
35,Yes,Travel_Rarely,760,Sales,15,3,Marketing,1,1183,3,Male,56,3,2,Sales Executive,2,Married,6000,12000,2,Y,No,17,3,2,80,2,12,2,2,8,6,3,7
43,No,Travel_Frequently,940,Research & Development,8,4,Life Sciences,1,1184,2,Female,70,3,3,Laboratory Technician,2,Single,6400,13200,4,Y,Yes,19,3,3,80,2,20,3,3,15,10,6,12
31,No,Travel_Rarely,680,Human Resources,20,3,Human Resources,1,1185,1,Male,49,2,1,Human Resources,1,Married,3800,9000,1,Y,No,15,3,1,80,0,8,2,1,5,3,1,4
40,Yes,Non-Travel,880,Sales,12,3,Technical Degree,1,1186,4,Female,65,3,3,Sales Executive,4,Divorced,7200,14000,3,Y,Yes,18,3,4,80,1,17,3,3,13,8,5,10
27,No,Travel_Frequently,580,Research & Development,23,2,Medical,1,1187,2,Male,41,2,1,Research Scientist,2,Single,3000,7600,1,Y,No,13,3,1,80,0,4,2,1,3,2,0,2
48,No,Travel_Rarely,1120,Sales,6,4,Life Sciences,1,1188,3,Female,78,4,3,Manager,3,Married,10800,16600,5,Y,No,22,4,3,80,0,25,4,3,19,13,8,16
32,Yes,Travel_Frequently,700,Research & Development,18,3,Other,1,1189,1,Male,51,3,2,Healthcare Representative,1,Divorced,4800,10400,2,Y,Yes,16,3,2,80,3,9,2,2,6,4,2,5
37,No,Travel_Rarely,820,Sales,11,3,Marketing,1,1190,4,Female,60,3,2,Sales Executive,4,Single,6800,13600,2,Y,No,17,3,4,80,1,14,3,2,10,7,3,8
29,No,Travel_Frequently,620,Research & Development,21,2,Life Sciences,1,1191,2,Male,44,2,1,Laboratory Technician,2,Married,3400,8200,1,Y,Yes,14,3,1,80,0,6,2,1,4,2,1,3
44,Yes,Non-Travel,980,Sales,7,4,Technical Degree,1,1192,3,Female,72,4,3,Sales Executive,3,Single,8000,15200,4,Y,No,20,4,3,80,2,21,3,3,15,11,6,12
33,No,Travel_Rarely,720,Research & Development,16,3,Medical,1,1193,4,Male,52,3,2,Research Scientist,4,Married,4800,10600,2,Y,Yes,15,3,4,80,1,10,2,2,7,5,2,6
39,No,Travel_Frequently,860,Sales,13,3,Life Sciences,1,1194,1,Female,63,3,2,Sales Executive,1,Divorced,6600,13000,3,Y,No,18,3,2,80,2,16,3,2,12,8,4,10
24,Yes,Travel_Rarely,520,Human Resources,27,1,Human Resources,1,1195,2,Male,36,1,1,Human Resources,2,Single,2200,6600,0,Y,No,11,3,1,80,0,1,1,1,1,0,0,0
47,No,Travel_Frequently,1080,Research & Development,4,5,Other,1,1196,3,Female,76,4,4,Research Director,3,Married,13000,18600,5,Y,Yes,24,4,3,80,1,24,4,4,18,12,8,15
34,No,Non-Travel,740,Sales,19,3,Marketing,1,1197,2,Male,54,3,2,Sales Executive,2,Single,5800,11400,2,Y,No,16,3,2,80,1,11,2,2,7,5,2,6
42,Yes,Travel_Rarely,920,Research & Development,9,4,Life Sciences,1,1198,4,Female,68,3,3,Laboratory Technician,4,Married,6200,12800,4,Y,Yes,19,3,4,80,2,18,3,3,14,9,6,11
30,No,Travel_Frequently,640,Sales,22,2,Technical Degree,1,1199,1,Male,45,2,1,Sales Representative,1,Divorced,3600,8800,1,Y,No,13,3,1,80,0,7,2,1,5,3,1,4
45,No,Travel_Rarely,1000,Research & Development,8,4,Medical,1,1200,4,Female,73,4,3,Manufacturing Director,4,Single,8800,15400,4,Y,Yes,21,4,4,80,1,22,4,3,16,11,7,13
31,Yes,Travel_Frequently,680,Sales,17,3,Life Sciences,1,1201,3,Male,49,3,2,Sales Executive,2,Married,5400,10600,2,Y,No,15,3,2,80,2,8,2,2,5,3,1,4
38,No,Non-Travel,840,Research & Development,14,3,Other,1,1202,2,Female,61,3,2,Research Scientist,2,Single,5600,11800,3,Y,Yes,17,3,2,80,1,15,3,2,11,7,4,9
26,No,Travel_Rarely,560,Sales,25,1,Marketing,1,1203,1,Male,38,1,1,Sales Representative,1,Divorced,2800,7400,0,Y,No,12,3,1,80,0,3,1,1,2,1,0,1
51,Yes,Travel_Frequently,1200,Research & Development,5,5,Life Sciences,1,1204,4,Female,84,4,4,Research Director,3,Married,13600,19200,6,Y,No,24,4,3,80,1,28,4,4,22,16,11,19
35,No,Travel_Rarely,760,Sales,15,3,Technical Degree,1,1205,3,Male,55,3,2,Sales Executive,3,Single,6000,12000,2,Y,Yes,16,3,2,80,1,12,2,2,8,6,3,7
43,No,Travel_Frequently,940,Research & Development,11,4,Medical,1,1206,2,Female,69,3,3,Laboratory Technician,2,Married,6400,13000,4,Y,No,19,3,3,80,2,20,3,3,15,10,6,12
29,Yes,Non-Travel,620,Human Resources,23,2,Human Resources,1,1207,1,Male,43,2,1,Human Resources,1,Divorced,3200,8000,1,Y,Yes,14,3,1,80,0,6,2,1,4,2,1,3
44,No,Travel_Rarely,980,Sales,7,4,Life Sciences,1,1208,4,Female,71,3,3,Sales Executive,4,Single,8000,15000,3,Y,No,20,3,4,80,1,20,3,3,14,10,6,11
32,No,Travel_Frequently,700,Research & Development,18,3,Other,1,1209,3,Male,50,3,2,Research Scientist,3,Married,4600,10200,2,Y,Yes,15,3,2,80,1,9,2,2,6,4,2,5
40,Yes,Travel_Rarely,880,Sales,12,3,Marketing,1,1210,2,Female,65,3,2,Sales Executive,2,Divorced,7000,13600,3,Y,No,18,3,2,80,2,17,3,2,13,8,5,10
27,No,Travel_Frequently,580,Research & Development,24,2,Life Sciences,1,1211,1,Male,41,2,1,Laboratory Technician,1,Single,3000,7800,1,Y,Yes,13,3,1,80,0,4,2,1,3,2,0,2
49,No,Non-Travel,1160,Sales,6,4,Technical Degree,1,1212,4,Female,79,4,3,Manager,4,Married,11200,17000,5,Y,No,22,4,4,80,0,26,4,3,20,14,9,16
36,Yes,Travel_Rarely,800,Research & Development,16,3,Medical,1,1213,3,Male,57,3,2,Healthcare Representative,3,Single,5200,11000,2,Y,No,16,3,3,80,3,13,2,2,9,6,3,8
42,No,Travel_Frequently,920,Sales,9,4,Life Sciences,1,1214,2,Female,67,3,3,Sales Executive,2,Married,7400,14200,3,Y,Yes,19,3,3,80,1,18,3,3,14,9,6,11
28,No,Travel_Rarely,600,Research & Development,21,2,Other,1,1215,1,Male,42,2,1,Research Scientist,1,Divorced,3200,8000,1,Y,No,12,3,1,80,0,5,2,1,3,2,1,2
47,Yes,Travel_Frequently,1080,Sales,8,4,Marketing,1,1216,4,Female,76,4,3,Sales Executive,4,Single,8800,15600,4,Y,Yes,21,4,4,80,2,24,3,3,18,12,8,15
33,No,Non-Travel,720,Research & Development,19,3,Life Sciences,1,1217,3,Male,51,3,2,Research Scientist,3,Married,4800,10400,2,Y,No,14,3,2,80,1,10,2,2,7,5,2,6
39,No,Travel_Rarely,860,Sales,13,3,Technical Degree,1,1218,2,Female,62,3,2,Sales Executive,2,Single,6600,13200,3,Y,Yes,17,3,2,80,2,16,3,2,12,8,4,10
25,Yes,Travel_Frequently,540,Human Resources,26,1,Human Resources,1,1219,1,Male,36,1,1,Human Resources,1,Married,2400,6800,0,Y,No,11,3,1,80,0,2,1,1,2,1,0,1
50,No,Travel_Rarely,1180,Research & Development,4,5,Medical,1,1220,4,Female,82,4,4,Research Director,3,Divorced,13800,19400,6,Y,No,25,4,3,80,1,27,4,4,21,15,10,18
34,No,Travel_Frequently,740,Sales,17,3,Life Sciences,1,1221,3,Male,53,3,2,Sales Executive,3,Single,5800,11400,2,Y,Yes,16,3,2,80,1,11,2,2,7,5,2,6
41,Yes,Non-Travel,900,Research & Development,10,4,Other,1,1222,2,Female,66,3,3,Laboratory Technician,2,Married,6000,12600,4,Y,No,18,3,3,80,2,18,3,3,14,9,6,11
30,No,Travel_Rarely,640,Sales,22,2,Marketing,1,1223,1,Male,44,2,1,Sales Representative,1,Divorced,3600,8600,1,Y,Yes,14,3,1,80,0,7,2,1,5,3,1,4
46,No,Travel_Frequently,1040,Research & Development,7,4,Life Sciences,1,1224,4,Female,74,4,3,Manufacturing Director,4,Single,9000,15800,4,Y,No,20,4,4,80,1,23,4,3,17,12,7,14
32,Yes,Travel_Rarely,700,Sales,18,3,Technical Degree,1,1225,3,Male,48,3,2,Sales Executive,2,Married,5000,10400,2,Y,No,15,3,2,80,2,9,2,2,6,4,2,5
38,No,Travel_Frequently,840,Research & Development,14,3,Medical,1,1226,2,Female,60,3,2,Research Scientist,2,Single,5600,11600,3,Y,Yes,17,3,2,80,1,15,3,2,11,7,4,9
26,No,Non-Travel,560,Human Resources,25,1,Human Resources,1,1227,1,Male,37,1,1,Human Resources,1,Divorced,2800,7200,0,Y,No,12,3,1,80,0,3,1,1,2,1,0,1
52,Yes,Travel_Rarely,1220,Sales,5,5,Life Sciences,1,1228,4,Female,85,4,4,Manager,3,Married,12800,18800,6,Y,Yes,24,4,3,80,0,29,4,4,23,17,12,20
35,No,Travel_Frequently,760,Research & Development,16,3,Other,1,1229,3,Male,54,3,2,Healthcare Representative,3,Single,5000,10800,2,Y,No,16,3,3,80,3,12,2,2,8,6,3,7
43,No,Travel_Rarely,940,Sales,11,4,Marketing,1,1230,2,Female,68,3,3,Sales Executive,2,Married,7600,14400,3,Y,Yes,19,3,3,80,1,20,3,3,15,10,6,12
31,Yes,Travel_Frequently,680,Research & Development,23,3,Life Sciences,1,1231,1,Male,47,2,1,Laboratory Technician,1,Divorced,3800,9000,1,Y,No,13,3,1,80,0,8,2,1,5,3,1,4
40,No,Non-Travel,880,Sales,8,3,Technical Degree,1,1232,4,Female,64,3,3,Sales Executive,4,Single,7200,14000,3,Y,Yes,18,3,4,80,1,17,3,3,13,8,5,10
27,No,Travel_Rarely,580,Research & Development,20,2,Medical,1,1233,2,Male,40,2,1,Research Scientist,2,Married,3000,7600,1,Y,No,14,3,1,80,0,4,2,1,3,2,0,2
48,Yes,Travel_Frequently,1120,Sales,6,4,Life Sciences,1,1234,3,Female,77,4,3,Manager,3,Single,10800,16600,5,Y,No,22,4,3,80,0,25,4,3,19,13,8,16
33,No,Travel_Rarely,720,Research & Development,17,3,Other,1,1235,4,Male,50,3,2,Research Scientist,4,Married,4800,10200,2,Y,Yes,15,3,4,80,1,10,2,2,7,5,2,6
37,No,Travel_Frequently,820,Sales,12,3,Marketing,1,1236,1,Female,59,3,2,Sales Executive,1,Divorced,6800,13400,2,Y,No,17,3,2,80,2,14,3,2,10,7,3,8
29,Yes,Travel_Rarely,620,Human Resources,24,2,Human Resources,1,1237,2,Male,43,2,1,Human Resources,2,Single,3200,8200,1,Y,Yes,13,3,1,80,0,6,2,1,4,2,1,3
44,No,Non-Travel,980,Research & Development,7,4,Life Sciences,1,1238,3,Female,70,4,3,Manufacturing Director,3,Married,8600,15400,4,Y,No,20,4,3,80,1,21,4,3,15,11,6,12
32,No,Travel_Frequently,700,Sales,19,3,Technical Degree,1,1239,2,Male,49,3,2,Sales Executive,2,Single,5200,10600,2,Y,Yes,16,3,2,80,1,9,2,2,6,4,2,5
39,Yes,Travel_Rarely,860,Research & Development,13,3,Medical,1,1240,4,Female,61,3,2,Research Scientist,4,Married,5800,11800,3,Y,No,18,3,4,80,2,16,2,2,12,8,4,10
24,No,Travel_Frequently,520,Sales,27,1,Life Sciences,1,1241,1,Male,35,1,1,Sales Representative,1,Divorced,2200,6600,0,Y,No,10,3,1,80,0,1,1,1,1,0,0,0
47,No,Non-Travel,1080,Research & Development,4,5,Other,1,1242,3,Female,75,4,4,Research Director,3,Single,13000,18600,5,Y,Yes,24,4,3,80,1,24,4,4,18,12,8,15
34,Yes,Travel_Rarely,740,Sales,16,3,Marketing,1,1243,2,Male,52,3,2,Sales Executive,2,Married,5800,11400,2,Y,No,15,3,2,80,2,11,2,2,7,5,2,6
42,No,Travel_Frequently,920,Research & Development,9,4,Life Sciences,1,1244,4,Female,67,3,3,Laboratory Technician,4,Single,6200,12800,4,Y,Yes,19,3,4,80,2,18,3,3,14,9,6,11
30,No,Travel_Rarely,640,Human Resources,21,2,Human Resources,1,1245,1,Male,44,2,1,Human Resources,1,Married,3400,8400,1,Y,No,14,3,1,80,0,7,2,1,5,3,1,4
45,Yes,Travel_Frequently,1000,Sales,8,4,Technical Degree,1,1246,3,Female,72,4,3,Sales Executive,3,Divorced,8200,15200,4,Y,Yes,21,4,3,80,1,22,3,3,16,11,7,13
31,No,Non-Travel,680,Research & Development,18,3,Medical,1,1247,2,Male,48,3,2,Research Scientist,2,Single,4400,10000,2,Y,No,13,3,2,80,1,8,2,2,5,3,1,4
38,No,Travel_Rarely,840,Sales,14,3,Life Sciences,1,1248,4,Female,60,3,2,Sales Executive,4,Married,6800,13600,2,Y,Yes,17,3,4,80,2,15,3,2,11,7,4,9
26,Yes,Travel_Frequently,560,Research & Development,26,1,Other,1,1249,1,Male,36,1,1,Laboratory Technician,1,Single,2800,7200,0,Y,No,12,3,1,80,0,3,1,1,2,1,0,1
51,No,Travel_Rarely,1200,Sales,5,5,Marketing,1,1250,4,Female,83,4,4,Manager,4,Divorced,12600,18400,6,Y,No,25,4,4,80,0,28,4,4,22,16,11,19
35,No,Travel_Frequently,760,Research & Development,15,3,Life Sciences,1,1251,3,Male,53,3,2,Healthcare Representative,3,Married,5000,10800,2,Y,Yes,16,3,3,80,3,12,2,2,8,6,3,7
43,Yes,Travel_Rarely,940,Sales,10,4,Technical Degree,1,1252,2,Female,67,3,3,Sales Executive,2,Single,7400,14200,3,Y,No,19,3,3,80,1,20,3,3,15,10,6,12
29,No,Travel_Frequently,620,Research & Development,22,2,Medical,1,1253,1,Male,42,2,1,Research Scientist,1,Married,3400,8000,1,Y,Yes,14,3,1,80,0,6,2,1,4,2,1,3
48,No,Non-Travel,1140,Sales,7,4,Life Sciences,1,1254,4,Female,78,4,3,Sales Executive,4,Divorced,10400,16200,5,Y,No,23,4,4,80,2,25,4,3,19,13,8,16
33,Yes,Travel_Rarely,720,Research & Development,17,3,Other,1,1255,3,Male,49,3,2,Research Scientist,3,Single,4800,10400,2,Y,No,15,3,2,80,1,10,2,2,7,5,2,6
40,No,Travel_Frequently,880,Sales,11,3,Marketing,1,1256,2,Female,63,3,2,Sales Executive,2,Married,7000,13800,3,Y,Yes,18,3,2,80,2,17,3,2,13,8,5,10
27,No,Travel_Rarely,580,Human Resources,25,2,Human Resources,1,1257,1,Male,39,2,1,Human Resources,1,Single,3000,7800,1,Y,No,13,3,1,80,0,4,2,1,3,2,0,2
46,Yes,Travel_Frequently,1040,Research & Development,6,4,Life Sciences,1,1258,4,Female,73,4,3,Manufacturing Director,4,Married,9200,15800,4,Y,Yes,20,4,4,80,1,23,4,3,17,12,7,14
32,No,Non-Travel,700,Sales,19,3,Technical Degree,1,1259,3,Male,47,3,2,Sales Executive,3,Divorced,5200,10600,2,Y,No,16,3,2,80,2,9,2,2,6,4,2,5
37,No,Travel_Rarely,820,Research & Development,13,3,Medical,1,1260,2,Female,58,3,2,Research Scientist,2,Single,5600,11600,3,Y,Yes,17,3,2,80,1,14,3,2,10,7,3,8
28,Yes,Travel_Frequently,600,Sales,23,2,Life Sciences,1,1261,1,Male,41,2,1,Sales Representative,1,Married,3200,8200,1,Y,No,12,3,1,80,0,5,2,1,3,2,1,2
52,No,Travel_Rarely,1220,Research & Development,4,5,Other,1,1262,4,Female,84,4,4,Research Director,3,Single,14000,19800,6,Y,No,24,4,3,80,1,29,4,4,23,17,12,20
36,No,Travel_Frequently,800,Sales,16,3,Marketing,1,1263,3,Male,55,3,2,Sales Executive,3,Married,6200,12400,2,Y,Yes,15,3,2,80,1,13,2,2,9,6,3,8
42,Yes,Non-Travel,920,Research & Development,8,4,Life Sciences,1,1264,2,Female,66,3,3,Laboratory Technician,2,Divorced,6400,13000,4,Y,No,18,3,3,80,2,18,3,3,14,9,6,11
30,No,Travel_Rarely,640,Human Resources,20,2,Human Resources,1,1265,1,Male,43,2,1,Human Resources,1,Single,3600,8600,1,Y,Yes,13,3,1,80,0,7,2,1,5,3,1,4
44,No,Travel_Frequently,980,Sales,12,4,Technical Degree,1,1266,4,Female,69,3,3,Sales Executive,4,Married,8000,15000,3,Y,No,20,3,4,80,1,20,3,3,14,10,6,11
32,Yes,Travel_Rarely,700,Research & Development,24,3,Medical,1,1267,3,Male,46,3,2,Research Scientist,3,Single,4800,10400,2,Y,Yes,14,3,2,80,1,9,2,2,6,4,2,5
39,No,Travel_Frequently,860,Sales,9,3,Life Sciences,1,1268,2,Female,61,3,2,Sales Executive,2,Married,6600,13200,3,Y,No,17,3,2,80,2,16,3,2,12,8,4,10
25,No,Travel_Rarely,540,Research & Development,26,1,Other,1,1269,1,Male,34,1,1,Laboratory Technician,1,Divorced,2600,7000,0,Y,No,11,3,1,80,0,2,1,1,2,1,0,1
49,Yes,Travel_Frequently,1160,Sales,5,4,Marketing,1,1270,4,Female,77,4,3,Manager,4,Single,11000,16800,5,Y,Yes,22,4,4,80,0,26,4,3,20,14,9,16
34,No,Non-Travel,740,Research & Development,18,3,Life Sciences,1,1271,3,Male,51,3,2,Healthcare Representative,3,Married,4800,10400,2,Y,No,15,3,3,80,3,11,2,2,7,5,2,6
41,No,Travel_Rarely,900,Sales,14,4,Technical Degree,1,1272,2,Female,64,3,3,Sales Executive,2,Single,7200,14000,3,Y,Yes,18,3,3,80,1,18,3,3,14,9,6,11
28,Yes,Travel_Frequently,600,Research & Development,21,2,Medical,1,1273,1,Male,40,2,1,Research Scientist,1,Married,3200,8000,1,Y,No,13,3,1,80,0,5,2,1,3,2,1,2
47,No,Travel_Rarely,1080,Sales,7,4,Life Sciences,1,1274,4,Female,75,4,3,Sales Executive,4,Divorced,8800,15600,4,Y,No,21,4,4,80,2,24,3,3,18,12,8,15
33,No,Travel_Frequently,720,Research & Development,19,3,Other,1,1275,3,Male,48,3,2,Research Scientist,3,Single,4600,10200,2,Y,Yes,16,3,2,80,1,10,2,2,7,5,2,6
38,Yes,Non-Travel,840,Sales,13,3,Marketing,1,1276,2,Female,57,3,2,Sales Executive,2,Married,6400,12800,3,Y,No,17,3,2,80,2,15,3,2,11,7,4,9
26,No,Travel_Rarely,560,Human Resources,25,1,Human Resources,1,1277,1,Male,35,1,1,Human Resources,1,Single,2800,7400,0,Y,Yes,12,3,1,80,0,3,1,1,2,1,0,1
50,No,Travel_Frequently,1180,Research & Development,6,5,Life Sciences,1,1278,4,Female,81,4,4,Research Director,3,Married,13400,19000,6,Y,No,25,4,3,80,1,27,4,4,21,15,10,18
35,Yes,Travel_Rarely,760,Sales,16,3,Technical Degree,1,1279,3,Male,52,3,2,Sales Executive,2,Divorced,6000,12000,2,Y,Yes,17,3,2,80,2,12,2,2,8,6,3,7
43,No,Travel_Frequently,940,Research & Development,10,4,Medical,1,1280,2,Female,65,3,3,Laboratory Technician,2,Single,6400,13200,4,Y,No,19,3,3,80,2,20,3,3,15,10,6,12
31,No,Travel_Rarely,680,Sales,22,3,Life Sciences,1,1281,1,Male,44,2,1,Sales Representative,1,Married,3800,8800,1,Y,Yes,14,3,1,80,0,8,2,1,5,3,1,4
40,Yes,Non-Travel,880,Research & Development,8,3,Other,1,1282,4,Female,62,3,3,Manufacturing Director,4,Single,7000,13600,4,Y,No,18,4,4,80,1,17,3,3,13,8,5,10
27,No,Travel_Frequently,580,Sales,24,2,Marketing,1,1283,2,Male,38,2,1,Sales Representative,2,Divorced,3000,7600,1,Y,No,13,3,1,80,0,4,2,1,3,2,0,2
48,No,Travel_Rarely,1120,Research & Development,5,4,Life Sciences,1,1284,3,Female,74,4,3,Research Scientist,3,Married,8400,15200,5,Y,Yes,22,4,3,80,0,25,4,3,19,13,8,16
32,Yes,Travel_Frequently,700,Sales,17,3,Technical Degree,1,1285,1,Male,45,3,2,Sales Executive,1,Single,5000,10400,2,Y,No,15,3,2,80,1,9,2,2,6,4,2,5
37,No,Non-Travel,820,Research & Development,11,3,Medical,1,1286,4,Female,56,3,2,Research Scientist,4,Married,5600,11600,3,Y,Yes,17,3,4,80,2,14,3,2,10,7,3,8
29,No,Travel_Rarely,620,Human Resources,23,2,Human Resources,1,1287,2,Male,41,2,1,Human Resources,2,Single,3400,8200,1,Y,No,14,3,1,80,0,6,2,1,4,2,1,3
44,Yes,Travel_Frequently,980,Sales,7,4,Life Sciences,1,1288,3,Female,68,4,3,Manager,3,Divorced,9600,16200,5,Y,Yes,20,4,3,80,1,21,4,3,15,11,6,12
33,No,Travel_Rarely,720,Research & Development,18,3,Other,1,1289,4,Male,47,3,2,Research Scientist,4,Single,4800,10600,2,Y,No,16,3,4,80,1,10,2,2,7,5,2,6
39,No,Travel_Frequently,860,Sales,14,3,Marketing,1,1290,1,Female,59,3,2,Sales Executive,1,Married,6600,13000,3,Y,Yes,18,3,2,80,2,16,3,2,12,8,4,10
24,Yes,Travel_Rarely,520,Research & Development,27,1,Life Sciences,1,1291,2,Male,33,1,1,Laboratory Technician,2,Single,2200,6600,0,Y,No,10,3,1,80,0,1,1,1,1,0,0,0
47,No,Travel_Frequently,1080,Sales,4,5,Technical Degree,1,1292,3,Female,73,4,4,Sales Executive,3,Married,10800,16600,5,Y,No,24,4,3,80,1,24,4,4,18,12,8,15
34,No,Non-Travel,740,Research & Development,19,3,Medical,1,1293,2,Male,50,3,2,Healthcare Representative,2,Single,4800,10400,2,Y,Yes,15,3,2,80,3,11,2,2,7,5,2,6
42,Yes,Travel_Rarely,920,Sales,13,4,Life Sciences,1,1294,4,Female,63,3,3,Sales Executive,4,Married,7400,14200,3,Y,No,19,3,4,80,1,18,3,3,14,9,6,11
30,No,Travel_Frequently,640,Research & Development,20,2,Other,1,1295,1,Male,42,2,1,Research Scientist,1,Divorced,3600,8600,1,Y,Yes,13,3,1,80,0,7,2,1,5,3,1,4
45,No,Travel_Rarely,1000,Sales,9,4,Marketing,1,1296,3,Female,71,4,3,Sales Executive,3,Single,8200,15400,4,Y,No,21,4,3,80,2,22,3,3,16,11,7,13
31,Yes,Travel_Frequently,680,Research & Development,16,3,Life Sciences,1,1297,2,Male,46,3,2,Research Scientist,2,Married,4400,10000,2,Y,No,14,3,2,80,1,8,2,2,5,3,1,4
38,No,Non-Travel,840,Sales,12,3,Technical Degree,1,1298,4,Female,55,3,2,Sales Executive,4,Single,6800,13600,2,Y,Yes,17,3,4,80,2,15,3,2,11,7,4,9
26,No,Travel_Rarely,560,Human Resources,26,1,Human Resources,1,1299,1,Male,34,1,1,Human Resources,1,Married,2800,7200,0,Y,No,17,3,4,80,2,15,3,2,11,7,4,9
31,Yes,Travel_Frequently,680,Sales,18,3,Life Sciences,1,1300,2,Male,45,3,2,Sales Executive,2,Single,5200,10600,2,Y,No,15,3,2,80,1,9,2,2,6,4,2,5
29,No,Non-Travel,620,Research & Development,22,2,Medical,1,1301,3,Male,40,2,1,Research Scientist,1,Divorced,3600,8600,1,Y,Yes,13,3,1,80,0,7,2,1,5,3,1,4